"","Country","Year","Age","Female","Male","Total"
"221","Afghanistan",1997,0,1703418,1811602,3515020
"222","Afghanistan",1997,5,1345949,1463449,2809398
"223","Afghanistan",1997,10,1113734,1222135,2335869
"224","Afghanistan",1997,15,918845,1016028,1934873
"225","Afghanistan",1997,20,744539,820453,1564992
"226","Afghanistan",1997,25,604642,661567,1266209
"227","Afghanistan",1997,30,493331,538299,1031630
"228","Afghanistan",1997,35,408266,442658,850924
"229","Afghanistan",1997,40,339432,363770,703202
"230","Afghanistan",1997,45,305389,295750,601139
"231","Afghanistan",1997,50,222513,237862,460375
"232","Afghanistan",1997,55,171354,176981,348335
"233","Afghanistan",1997,60,129331,130445,259776
"234","Afghanistan",1997,65,95626,98706,194332
"235","Afghanistan",1997,70,65558,63241,128799
"236","Afghanistan",1997,75,35951,32394,68345
"237","Afghanistan",1997,80,15624,13538,29162
"238","Afghanistan",1997,85,3956,3271,7227
"239","Afghanistan",1997,90,490,425,915
"240","Afghanistan",1997,95,87,53,140
"241","Albania",1991,0,188264,201978,390242
"242","Albania",1991,5,170479,183918,354397
"243","Albania",1991,10,160551,171807,332358
"244","Albania",1991,15,155994,164207,320201
"245","Albania",1991,20,149349,155586,304935
"246","Albania",1991,25,146685,151423,298108
"247","Albania",1991,30,127471,130679,258150
"248","Albania",1991,35,101895,104036,205931
"249","Albania",1991,40,78895,84267,163162
"250","Albania",1991,45,69185,77527,146712
"251","Albania",1991,50,62773,71262,134035
"252","Albania",1991,55,49950,57324,107274
"253","Albania",1991,60,42860,47138,89998
"254","Albania",1991,65,34629,30572,65201
"255","Albania",1991,70,27052,23913,50965
"256","Albania",1991,75,19595,15715,35310
"257","Albania",1991,80,11910,7924,19834
"258","Albania",1991,85,4320,2685,7005
"259","Albania",1991,90,1294,707,2001
"260","Albania",1991,95,162,89,251
"261","Algeria",1991,0,1942453,2028375,3970828
"262","Algeria",1991,5,1863616,1940746,3804362
"263","Algeria",1991,10,1660376,1730639,3391015
"264","Algeria",1991,15,1408300,1466856,2875156
"265","Algeria",1991,20,1188893,1240598,2429491
"266","Algeria",1991,25,1005956,1049898,2055854
"267","Algeria",1991,30,808525,844647,1653172
"268","Algeria",1991,35,672423,699864,1372287
"269","Algeria",1991,40,449392,455694,905086
"270","Algeria",1991,45,369576,351353,720929
"271","Algeria",1991,50,339515,315890,655405
"272","Algeria",1991,55,300430,293698,594128
"273","Algeria",1991,60,242629,223231,465860
"274","Algeria",1991,65,172989,157664,330653
"275","Algeria",1991,70,141010,119708,260718
"276","Algeria",1991,75,88826,69315,158141
"277","Algeria",1991,80,49416,35562,84978
"278","Algeria",1991,85,14602,10482,25084
"279","Algeria",1991,90,3332,2002,5334
"280","Algeria",1991,95,248,143,391
"281","Argentina",2011,0,1769816,1836187,3606003
"282","Argentina",2011,5,1742274,1805900,3548174
"283","Argentina",2011,10,1716690,1776733,3493423
"284","Argentina",2011,15,1747745,1796869,3544614
"285","Argentina",2011,20,1665008,1680853,3345861
"286","Argentina",2011,25,1580816,1573057,3153873
"287","Argentina",2011,30,1586584,1546118,3132702
"288","Argentina",2011,35,1380905,1311913,2692818
"289","Argentina",2011,40,1229153,1150492,2379645
"290","Argentina",2011,45,1165273,1077806,2243079
"291","Argentina",2011,50,1069708,987932,2057640
"292","Argentina",2011,55,985477,899824,1885301
"293","Argentina",2011,60,871903,771384,1643287
"294","Argentina",2011,65,722371,595602,1317973
"295","Argentina",2011,70,596756,446618,1043374
"296","Argentina",2011,75,497082,326417,823499
"297","Argentina",2011,80,373315,198259,571574
"298","Argentina",2011,85,203755,87168,290923
"299","Argentina",2011,90,74531,24900,99431
"300","Argentina",2011,95,17838,4719,22557
"301","Australia",2003,0,617500,651143,1268643
"302","Australia",2003,5,640805,686110,1326915
"303","Australia",2003,10,673140,729628,1402768
"304","Australia",2003,15,673639,716277,1389916
"305","Australia",2003,20,691498,721124,1412622
"306","Australia",2003,25,661845,664101,1325946
"307","Australia",2003,30,759970,752140,1512110
"308","Australia",2003,35,728698,725176,1453874
"309","Australia",2003,40,773782,783880,1557662
"310","Australia",2003,45,727971,722181,1450152
"311","Australia",2003,50,663600,657037,1320637
"312","Australia",2003,55,614611,628289,1242900
"313","Australia",2003,60,456323,460869,917192
"314","Australia",2003,65,376151,371883,748034
"315","Australia",2003,70,318601,298125,616726
"316","Australia",2003,75,294591,250495,545086
"317","Australia",2003,80,236024,163129,399153
"318","Australia",2003,85,127072,63098,190170
"319","Australia",2003,90,58005,21648,79653
"320","Australia",2003,95,14648,3736,18384
"321","Austria",1990,0,208975,219869,428844
"322","Austria",1990,5,217702,228508,446210
"323","Austria",1990,10,211162,221472,432634
"324","Austria",1990,15,251532,262136,513668
"325","Austria",1990,20,313308,323914,637222
"326","Austria",1990,25,327054,335565,662619
"327","Austria",1990,30,294762,299914,594676
"328","Austria",1990,35,251063,252835,503898
"329","Austria",1990,40,259997,261871,521868
"330","Austria",1990,45,279290,276290,555580
"331","Austria",1990,50,240299,233625,473924
"332","Austria",1990,55,204232,194735,398967
"333","Austria",1990,60,218146,183165,401311
"334","Austria",1990,65,241655,149905,391560
"335","Austria",1990,70,145802,83534,229336
"336","Austria",1990,75,167552,87605,255157
"337","Austria",1990,80,120354,53590,173944
"338","Austria",1990,85,57523,21013,78536
"339","Austria",1990,90,16330,4538,20868
"340","Austria",1990,95,2545,587,3132
"341","Bangladesh",1991,0,7802669,8086878,15889547
"342","Bangladesh",1991,5,7124001,7415245,14539246
"343","Bangladesh",1991,10,6369378,6630975,13000353
"344","Bangladesh",1991,15,5521987,5725251,11247238
"345","Bangladesh",1991,20,4893662,5162625,10056287
"346","Bangladesh",1991,25,4083744,4379936,8463680
"347","Bangladesh",1991,30,2911386,3236911,6148297
"348","Bangladesh",1991,35,2026779,2308860,4335639
"349","Bangladesh",1991,40,2066606,2244094,4310700
"350","Bangladesh",1991,45,1918326,2073498,3991824
"351","Bangladesh",1991,50,1533014,1731352,3264366
"352","Bangladesh",1991,55,1219450,1397392,2616842
"353","Bangladesh",1991,60,971927,1093430,2065357
"354","Bangladesh",1991,65,710076,800937,1511013
"355","Bangladesh",1991,70,447745,515663,963408
"356","Bangladesh",1991,75,234686,274259,508945
"357","Bangladesh",1991,80,90829,109054,199883
"358","Bangladesh",1991,85,25229,26444,51673
"359","Bangladesh",1991,90,3997,3147,7144
"360","Bangladesh",1991,95,327,188,515
"1","Belgium",2003,0,54245,57076,111321
"2","Belgium",2003,5,225844,235491,461335
"3","Belgium",2003,10,290870,303988,594858
"4","Belgium",2003,15,310278,324907,635185
"5","Belgium",2003,20,295749,308920,604669
"6","Belgium",2003,25,319540,326231,645771
"7","Belgium",2003,30,324117,330683,654800
"8","Belgium",2003,35,365635,374781,740416
"9","Belgium",2003,40,394835,407125,801960
"10","Belgium",2003,45,396665,404869,801534
"11","Belgium",2003,50,370937,375847,746784
"12","Belgium",2003,55,343888,348258,692146
"13","Belgium",2003,60,307572,305293,612865
"14","Belgium",2003,65,252118,237692,489810
"15","Belgium",2003,70,261097,231550,492647
"16","Belgium",2003,75,264370,209282,473652
"17","Belgium",2003,80,228956,155037,383993
"18","Belgium",2003,85,156543.29,86004.3,242547.59
"19","Belgium",2003,90,76978.37,30714.48,107692.85
"20","Belgium",2003,95,48592.16,12848.6,61440.76
"361","Bolivia",1991,0,504967,525304,1030271
"362","Bolivia",1991,5,438360,454346,892706
"363","Bolivia",1991,10,396228,409444,805672
"364","Bolivia",1991,15,346952,358161,705113
"365","Bolivia",1991,20,297545,305593,603138
"366","Bolivia",1991,25,253874,258972,512846
"367","Bolivia",1991,30,217773,220737,438510
"368","Bolivia",1991,35,189346,190780,380126
"369","Bolivia",1991,40,163200,165399,328599
"370","Bolivia",1991,45,136347,137887,274234
"371","Bolivia",1991,50,110356,109297,219653
"372","Bolivia",1991,55,97109,93153,190262
"373","Bolivia",1991,60,85624,79216,164840
"374","Bolivia",1991,65,66680,58552,125232
"375","Bolivia",1991,70,49392,40760,90152
"376","Bolivia",1991,75,33877,26118,59995
"377","Bolivia",1991,80,17659,12857,30516
"378","Bolivia",1991,85,6247,4229,10476
"379","Bolivia",1991,90,1363,791,2154
"380","Bolivia",1991,95,236,108,344
"381","Brazil",1991,0,8742488,9044382,17786870
"382","Brazil",1991,5,8918481,9148462,18066943
"383","Brazil",1991,10,8185006,8348726,16533732
"384","Brazil",1991,15,7370004,7460876,14830880
"385","Brazil",1991,20,7056218,7066516,14122734
"386","Brazil",1991,25,6636039,6584205,13220244
"387","Brazil",1991,30,5726108,5642673,11368781
"388","Brazil",1991,35,4881471,4781638,9663109
"389","Brazil",1991,40,3941826,3832457,7774283
"390","Brazil",1991,45,3119281,2999568,6118849
"391","Brazil",1991,50,2758514,2616700,5375214
"392","Brazil",1991,55,2188260,2036697,4224957
"393","Brazil",1991,60,1873841,1692631,3566472
"394","Brazil",1991,65,1370842,1180619,2551461
"395","Brazil",1991,70,964885,780718,1745603
"396","Brazil",1991,75,652829,500825,1153654
"397","Brazil",1991,80,353186,248252,601438
"398","Brazil",1991,85,139809,86460,226269
"399","Brazil",1991,90,39970,22132,62102
"400","Brazil",1991,95,6390,3240,9630
"401","Burkina Faso",1991,0,817988,844893,1662881
"402","Burkina Faso",1991,5,668367,689318,1357685
"403","Burkina Faso",1991,10,562824,580109,1142933
"404","Burkina Faso",1991,15,462716,473666,936382
"405","Burkina Faso",1991,20,387186,386736,773922
"406","Burkina Faso",1991,25,314665,299739,614404
"407","Burkina Faso",1991,30,257469,230402,487871
"408","Burkina Faso",1991,35,209499,174326,383825
"409","Burkina Faso",1991,40,174724,142079,316803
"410","Burkina Faso",1991,45,153223,119062,272285
"411","Burkina Faso",1991,50,129353,96497,225850
"412","Burkina Faso",1991,55,108938,78658,187596
"413","Burkina Faso",1991,60,92311,67025,159336
"414","Burkina Faso",1991,65,73503,54820,128323
"415","Burkina Faso",1991,70,51037,38338,89375
"416","Burkina Faso",1991,75,28159,20710,48869
"417","Burkina Faso",1991,80,10639,7514,18153
"418","Burkina Faso",1991,85,2438,1617,4055
"419","Burkina Faso",1991,90,287,172,459
"420","Burkina Faso",1991,95,17,9,26
"421","Cameroon",1999,0,1311870,1336214,2648084
"422","Cameroon",1999,5,1141685,1158412,2300097
"423","Cameroon",1999,10,1017748,1029275,2047023
"424","Cameroon",1999,15,867943,875780,1743723
"425","Cameroon",1999,20,702212,704780,1406992
"426","Cameroon",1999,25,567558,565242,1132800
"427","Cameroon",1999,30,458712,454822,913534
"428","Cameroon",1999,35,370385,364622,735007
"429","Cameroon",1999,40,299905,291701,591606
"430","Cameroon",1999,45,252738,241877,494615
"431","Cameroon",1999,50,209759,195007,404766
"432","Cameroon",1999,55,174185,158173,332358
"433","Cameroon",1999,60,145549,128128,273677
"434","Cameroon",1999,65,113127,95793,208920
"435","Cameroon",1999,70,79988,64638,144626
"436","Cameroon",1999,75,48416,36910,85326
"437","Cameroon",1999,80,22390,15961,38351
"438","Cameroon",1999,85,6525,4326,10851
"439","Cameroon",1999,90,925,572,1497
"440","Cameroon",1999,95,57,34,91
"441","Canada",1998,0,872149,914063,1786212
"442","Canada",1998,5,989229,1038649,2027878
"443","Canada",1998,10,998470,1049297,2047767
"444","Canada",1998,15,1014575,1073621,2088196
"445","Canada",1998,20,1007400,1055672,2063072
"446","Canada",1998,25,1019803,1047487,2067290
"447","Canada",1998,30,1118597,1138313,2256910
"448","Canada",1998,35,1322793,1344753,2667546
"449","Canada",1998,40,1295408,1295431,2590839
"450","Canada",1998,45,1160933,1144702,2305635
"451","Canada",1998,50,1017656,1016992,2034648
"452","Canada",1998,55,782288,771165,1553453
"453","Canada",1998,60,640445,615065,1255510
"454","Canada",1998,65,591004,550259,1141263
"455","Canada",1998,70,544271,457748,1002019
"456","Canada",1998,75,468132,334624,802756
"457","Canada",1998,80,312504,185735,498239
"458","Canada",1998,85,184648,87221,271869
"459","Canada",1998,90,74050,26085,100135
"460","Canada",1998,95,21706,5436,27142
"461","Chad",1999,0,838803,849532,1688335
"462","Chad",1999,5,659672,666208,1325880
"463","Chad",1999,10,531808,537599,1069407
"464","Chad",1999,15,434300,438588,872888
"465","Chad",1999,20,354728,356797,711525
"466","Chad",1999,25,284774,284281,569055
"467","Chad",1999,30,223056,221641,444697
"468","Chad",1999,35,185847,181218,367065
"469","Chad",1999,40,159827,151146,310973
"470","Chad",1999,45,138203,126045,264248
"471","Chad",1999,50,100472,95873,196345
"472","Chad",1999,55,84218,79618,163836
"473","Chad",1999,60,69271,63265,132536
"474","Chad",1999,65,53989,46267,100256
"475","Chad",1999,70,38156,31310,69466
"476","Chad",1999,75,23511,18254,41765
"477","Chad",1999,80,11191,8288,19479
"478","Chad",1999,85,3882,2499,6381
"479","Chad",1999,90,889,453,1342
"480","Chad",1999,95,127,48,175
"481","Chile",1990,0,696068,721402,1417470
"482","Chile",1990,5,642447,664283,1306730
"483","Chile",1990,10,628201,645835,1274036
"484","Chile",1990,15,615656,627242,1242898
"485","Chile",1990,20,615861,619690,1235551
"486","Chile",1990,25,599974,594923,1194897
"487","Chile",1990,30,544931,532186,1077117
"488","Chile",1990,35,481437,462860,944297
"489","Chile",1990,40,380679,364257,744936
"490","Chile",1990,45,319435,295672,615107
"491","Chile",1990,50,277320,247582,524902
"492","Chile",1990,55,255394,220739,476133
"493","Chile",1990,60,235833,197555,433388
"494","Chile",1990,65,169716,133564,303280
"495","Chile",1990,70,120507,88331,208838
"496","Chile",1990,75,84904,57073,141977
"497","Chile",1990,80,50726,30285,81011
"498","Chile",1990,85,24360,12232,36592
"499","Chile",1990,90,8906,3547,12453
"500","Chile",1990,95,2320,684,3004
"501","China",1990,0,64094588,68872194,132966782
"502","China",1990,5,50169756,53316561,103486317
"503","China",1990,10,48525604,51489006,100014610
"504","China",1990,15,60807019,64345914,125152933
"505","China",1990,20,63877295,66518943,130396238
"506","China",1990,25,51907908,54736019,106643927
"507","China",1990,30,42432932,44821763,87254695
"508","China",1990,35,44018789,46359500,90378289
"509","China",1990,40,30995258,32707193,63702451
"510","China",1990,45,23303843,25902876,49206719
"511","China",1990,50,21598087,24462060,46060147
"512","China",1990,55,19828966,21855872,41684838
"513","China",1990,60,16091508,17583763,33675271
"514","China",1990,65,13151297,13105870,26257167
"515","China",1990,70,10593783,9816398,20410181
"516","China",1990,75,6823984,5277930,12101914
"517","China",1990,80,3334716,2004682,5339398
"518","China",1990,85,1193395,571309,1764704
"519","China",1990,90,240716,99362,340078
"520","China",1990,95,34762,12260,47022
"521","Colombia",1991,0,2054196,2141208,4195404
"522","Colombia",1991,5,1961685,2031903,3993588
"523","Colombia",1991,10,1852428,1889778,3742206
"524","Colombia",1991,15,1697621,1681020,3378641
"525","Colombia",1991,20,1655425,1634620,3290045
"526","Colombia",1991,25,1530525,1489366,3019891
"527","Colombia",1991,30,1273252,1182793,2456045
"528","Colombia",1991,35,1081833,1006758,2088591
"529","Colombia",1991,40,840627,780336,1620963
"530","Colombia",1991,45,663458,599638,1263096
"531","Colombia",1991,50,557887,504015,1061902
"532","Colombia",1991,55,474920,422941,897861
"533","Colombia",1991,60,381238,335939,717177
"534","Colombia",1991,65,287492,245540,533032
"535","Colombia",1991,70,205558,169428,374986
"536","Colombia",1991,75,144082,111761,255843
"537","Colombia",1991,80,77827,56874,134701
"538","Colombia",1991,85,33355,23190,56545
"539","Colombia",1991,90,11091,6685,17776
"540","Colombia",1991,95,2763,1513,4276
"541","Costa Rica",1991,0,203478,212682,416160
"542","Costa Rica",1991,5,182517,190336,372853
"543","Costa Rica",1991,10,157948,164103,322051
"544","Costa Rica",1991,15,136821,140133,276954
"545","Costa Rica",1991,20,142122,144967,287089
"546","Costa Rica",1991,25,144061,147037,291098
"547","Costa Rica",1991,30,123550,125550,249100
"548","Costa Rica",1991,35,96303,97280,193583
"549","Costa Rica",1991,40,82837,84445,167282
"550","Costa Rica",1991,45,64806,65486,130292
"551","Costa Rica",1991,50,54008,54267,108275
"552","Costa Rica",1991,55,44973,44108,89081
"553","Costa Rica",1991,60,37147,35492,72639
"554","Costa Rica",1991,65,28066,25937,54003
"555","Costa Rica",1991,70,20227,17825,38052
"556","Costa Rica",1991,75,14639,11976,26615
"557","Costa Rica",1991,80,8719,6432,15151
"558","Costa Rica",1991,85,4092,2610,6702
"559","Costa Rica",1991,90,1354,694,2048
"560","Costa Rica",1991,95,299,109,408
"561","Croatia",1997,0,118129,124937,243066
"562","Croatia",1997,5,140420,148419,288839
"563","Croatia",1997,10,155328,164228,319556
"564","Croatia",1997,15,154129,162732,316861
"565","Croatia",1997,20,149944,157748,307692
"566","Croatia",1997,25,145321,147725,293046
"567","Croatia",1997,30,166830,165380,332210
"568","Croatia",1997,35,177002,179294,356296
"569","Croatia",1997,40,178885,187373,366258
"570","Croatia",1997,45,161232,165137,326369
"571","Croatia",1997,50,123204,118338,241542
"572","Croatia",1997,55,155072,142601,297673
"573","Croatia",1997,60,158589,136946,295535
"574","Croatia",1997,65,142820,106019,248839
"575","Croatia",1997,70,118442,61615,180057
"576","Croatia",1997,75,57528,28583,86111
"577","Croatia",1997,80,48528,22405,70933
"578","Croatia",1997,85,24979,10694,35673
"579","Croatia",1997,90,6223,2603,8826
"580","Croatia",1997,95,962,419,1381
"581","Cuba",1998,0,365975,384498,750473
"582","Cuba",1998,5,376597,397047,773644
"583","Cuba",1998,10,429157,448245,877402
"584","Cuba",1998,15,369452,379071,748523
"585","Cuba",1998,20,366448,377339,743787
"586","Cuba",1998,25,520184,535656,1055840
"587","Cuba",1998,30,547034,543404,1090438
"588","Cuba",1998,35,536430,531276,1067706
"589","Cuba",1998,40,348322,341973,690295
"590","Cuba",1998,45,348627,330913,679540
"591","Cuba",1998,50,297875,290332,588207
"592","Cuba",1998,55,268664,263517,532181
"593","Cuba",1998,60,220983,211376,432359
"594","Cuba",1998,65,172664,163657,336321
"595","Cuba",1998,70,146279,132389,278668
"596","Cuba",1998,75,113943,98472,212415
"597","Cuba",1998,80,79788,66110,145898
"598","Cuba",1998,85,46539,34602,81141
"599","Cuba",1998,90,18705,13137,31842
"600","Cuba",1998,95,5659,4084,9743
"601","Cyprus",1991,0,33818,36360,70178
"602","Cyprus",1991,5,31942,34367,66309
"603","Cyprus",1991,10,28591,30334,58925
"604","Cyprus",1991,15,27532,29833,57365
"605","Cyprus",1991,20,31765,36715,68480
"606","Cyprus",1991,25,30195,33531,63726
"607","Cyprus",1991,30,30014,31639,61653
"608","Cyprus",1991,35,26541,27998,54539
"609","Cyprus",1991,40,24333,24886,49219
"610","Cyprus",1991,45,21660,21787,43447
"611","Cyprus",1991,50,18504,18109,36613
"612","Cyprus",1991,55,16504,15605,32109
"613","Cyprus",1991,60,15040,13068,28108
"614","Cyprus",1991,65,13219,11573,24792
"615","Cyprus",1991,70,10787,9264,20051
"616","Cyprus",1991,75,8300,6658,14958
"617","Cyprus",1991,80,6050,4715,10765
"618","Cyprus",1991,85,2402,1707,4109
"619","Cyprus",1991,90,671,413,1084
"620","Cyprus",1991,95,117,69,186
"21","Czechia",2009,0,58492.8,61500,119992.8
"22","Czechia",2009,5,206223.14,217349.38,423572.52
"23","Czechia",2009,10,222352.34,235413.11,457765.45
"24","Czechia",2009,15,230933.71,243597.38,474531.09
"25","Czechia",2009,20,310336.97,325618.09,635955.06
"26","Czechia",2009,25,336061.84,355241.58,691303.42
"27","Czechia",2009,30,372578.37,394411.32,766989.69
"28","Czechia",2009,35,453244.01,476631.02,929875.03
"29","Czechia",2009,40,382471.38,404747.38,787218.76
"30","Czechia",2009,45,342690.34,359959.75,702650.09
"31","Czechia",2009,50,320595.04,330710.78,651305.82
"32","Czechia",2009,55,366410.89,362931.2,729342.09
"33","Czechia",2009,60,392302.1,372929.68,765231.78
"34","Czechia",2009,65,373365.89,335231.08,708596.97
"35","Czechia",2009,70,277656,229778.96,507434.96
"36","Czechia",2009,75,210092.25,153168.17,363260.42
"37","Czechia",2009,80,199481.15,125244.13,324725.28
"38","Czechia",2009,85,149849.28,75214.69,225063.97
"39","Czechia",2009,90,78970.32,31207.23,110177.55
"40","Czechia",2009,95,19541.33,5805.01,25346.34
"41","Denmark",1993,0,32894,34757,67651
"42","Denmark",1993,5,121837,128236,250073
"43","Denmark",1993,10,133751,140336,274087
"44","Denmark",1993,15,142252,148500,290752
"45","Denmark",1993,20,170076,177825,347901
"46","Denmark",1993,25,182640,191684,374324
"47","Denmark",1993,30,205783,217918,423701
"48","Denmark",1993,35,184993,194267,379260
"49","Denmark",1993,40,182308,189972,372280
"50","Denmark",1993,45,184944,190261,375205
"51","Denmark",1993,50,201717,209165,410882
"52","Denmark",1993,55,153152,155670,308822
"53","Denmark",1993,60,132919,129104,262023
"54","Denmark",1993,65,124663,115655,240318
"55","Denmark",1993,70,124690,107752,232442
"56","Denmark",1993,75,116853,91841,208694
"57","Denmark",1993,80,96122,65816,161938
"58","Denmark",1993,85,74626,41816,116442
"59","Denmark",1993,90,41188,17716,58904
"60","Denmark",1993,95,18607,6361,24968
"621","Dominican Republic",1991,0,476195,493443,969638
"622","Dominican Republic",1991,5,451948,466838,918786
"623","Dominican Republic",1991,10,425708,430027,855735
"624","Dominican Republic",1991,15,394436,388508,782944
"625","Dominican Republic",1991,20,352768,343846,696614
"626","Dominican Republic",1991,25,306554,298617,605171
"627","Dominican Republic",1991,30,253200,250251,503451
"628","Dominican Republic",1991,35,197805,199945,397750
"629","Dominican Republic",1991,40,151396,154746,306142
"630","Dominican Republic",1991,45,122192,127003,249195
"631","Dominican Republic",1991,50,112887,118155,231042
"632","Dominican Republic",1991,55,95004,101708,196712
"633","Dominican Republic",1991,60,73974,80158,154132
"634","Dominican Republic",1991,65,53980,58573,112553
"635","Dominican Republic",1991,70,35973,38604,74577
"636","Dominican Republic",1991,75,21771,22111,43882
"637","Dominican Republic",1991,80,11332,10720,22052
"638","Dominican Republic",1991,85,4878,4298,9176
"639","Dominican Republic",1991,90,1654,1366,3020
"640","Dominican Republic",1991,95,518,401,919
"641","Ecuador",1992,0,693532,721253,1414785
"642","Ecuador",1992,5,638935,662908,1301843
"643","Ecuador",1992,10,590561,607545,1198106
"644","Ecuador",1992,15,547608,560584,1108192
"645","Ecuador",1992,20,489288,499639,988927
"646","Ecuador",1992,25,420589,427101,847690
"647","Ecuador",1992,30,358909,361427,720336
"648","Ecuador",1992,35,304738,304753,609491
"649","Ecuador",1992,40,224628,223757,448385
"650","Ecuador",1992,45,193540,191396,384936
"651","Ecuador",1992,50,157627,154552,312179
"652","Ecuador",1992,55,130796,126360,257156
"653","Ecuador",1992,60,105758,100528,206286
"654","Ecuador",1992,65,81894,76194,158088
"655","Ecuador",1992,70,61666,55099,116765
"656","Ecuador",1992,75,45403,38385,83788
"657","Ecuador",1992,80,25951,20394,46345
"658","Ecuador",1992,85,11675,8797,20472
"659","Ecuador",1992,90,3423,2599,6022
"660","Ecuador",1992,95,705,434,1139
"661","El Salvador",1996,0,380683,396936,777619
"662","El Salvador",1996,5,347633,360514,708147
"663","El Salvador",1996,10,320007,323694,643701
"664","El Salvador",1996,15,297387,291439,588826
"665","El Salvador",1996,20,261592,246238,507830
"666","El Salvador",1996,25,228225,202820,431045
"667","El Salvador",1996,30,200132,171928,372060
"668","El Salvador",1996,35,171109,144939,316048
"669","El Salvador",1996,40,150465,124720,275185
"670","El Salvador",1996,45,121525,103400,224925
"671","El Salvador",1996,50,105844,93101,198945
"672","El Salvador",1996,55,90322,83923,174245
"673","El Salvador",1996,60,73096,67379,140475
"674","El Salvador",1996,65,54946,48887,103833
"675","El Salvador",1996,70,42371,35383,77754
"676","El Salvador",1996,75,27911,21494,49405
"677","El Salvador",1996,80,15261,10525,25786
"678","El Salvador",1996,85,6255,3745,10000
"679","El Salvador",1996,90,1629,795,2424
"680","El Salvador",1996,95,256,93,349
"681","Estonia",1998,0,29776,31509,61285
"682","Estonia",1998,5,38667,41337,80004
"683","Estonia",1998,10,50248,54466,104714
"684","Estonia",1998,15,49527,52814,102341
"685","Estonia",1998,20,47663,50610,98273
"686","Estonia",1998,25,49244,51250,100494
"687","Estonia",1998,30,46176,46203,92379
"688","Estonia",1998,35,50850,50000,100850
"689","Estonia",1998,40,52831,49890,102721
"690","Estonia",1998,45,51461,46229,97690
"691","Estonia",1998,50,47510,40099,87609
"692","Estonia",1998,55,42289,33847,76136
"693","Estonia",1998,60,48970,35533,84503
"694","Estonia",1998,65,42863,27940,70803
"695","Estonia",1998,70,40846,21667,62513
"696","Estonia",1998,75,29661,10839,40500
"697","Estonia",1998,80,13981,4691,18672
"698","Estonia",1998,85,9974,2781,12755
"699","Estonia",1998,90,3381,739,4120
"700","Estonia",1998,95,634,115,749
"701","Eswatini",2007,0,71369,72479,143848
"702","Eswatini",2007,5,69472,69690,139162
"703","Eswatini",2007,10,71638,71269,142907
"704","Eswatini",2007,15,65508,61031,126539
"705","Eswatini",2007,20,58867,49418,108285
"706","Eswatini",2007,25,44382,34632,79014
"707","Eswatini",2007,30,33964,28938,62902
"708","Eswatini",2007,35,27396,22774,50170
"709","Eswatini",2007,40,22779,17145,39924
"710","Eswatini",2007,45,18237,15335,33572
"711","Eswatini",2007,50,14405,13429,27834
"712","Eswatini",2007,55,11934,11578,23512
"713","Eswatini",2007,60,10208,8778,18986
"714","Eswatini",2007,65,8642,5992,14634
"715","Eswatini",2007,70,6212,3689,9901
"716","Eswatini",2007,75,3743,1945,5688
"717","Eswatini",2007,80,1814,832,2646
"718","Eswatini",2007,85,633,237,870
"719","Eswatini",2007,90,127,37,164
"720","Eswatini",2007,95,14,3,17
"721","Ethiopia",1993,0,5213778,5321231,10535009
"722","Ethiopia",1993,5,4287312,4377835,8665147
"723","Ethiopia",1993,10,3655535,3718042,7373577
"724","Ethiopia",1993,15,2919647,2922861,5842508
"725","Ethiopia",1993,20,2372834,2443381,4816215
"726","Ethiopia",1993,25,2004320,1899119,3903439
"727","Ethiopia",1993,30,1632200,1515790,3147990
"728","Ethiopia",1993,35,1436753,1303881,2740634
"729","Ethiopia",1993,40,1171143,1123182,2294325
"730","Ethiopia",1993,45,1039184,966647,2005831
"731","Ethiopia",1993,50,825816,799529,1625345
"732","Ethiopia",1993,55,639206,628170,1267376
"733","Ethiopia",1993,60,531388,536116,1067504
"734","Ethiopia",1993,65,366269,336533,702802
"735","Ethiopia",1993,70,267009,258051,525060
"736","Ethiopia",1993,75,144353,182999,327352
"737","Ethiopia",1993,80,72098,85398,157496
"738","Ethiopia",1993,85,22240,18897,41137
"739","Ethiopia",1993,90,5367,2879,8246
"740","Ethiopia",1993,95,675,238,913
"61","Finland",1997,0,29482,30966,60448
"62","Finland",1997,5,127354,132370,259724
"63","Finland",1997,10,157050,163925,320975
"64","Finland",1997,15,159922,167498,327420
"65","Finland",1997,20,159261,166083,325344
"66","Finland",1997,25,151543,159086,310629
"67","Finland",1997,30,164059,170510,334569
"68","Finland",1997,35,184737,192790,377527
"69","Finland",1997,40,186520,193667,380187
"70","Finland",1997,45,198430,204651,403081
"71","Finland",1997,50,210461,218371,428832
"72","Finland",1997,55,166161,168729,334890
"73","Finland",1997,60,145428,140106,285534
"74","Finland",1997,65,125929,114076,240005
"75","Finland",1997,70,130460,105880,236340
"76","Finland",1997,75,120441,78832,199273
"77","Finland",1997,80,93711,47688,141399
"78","Finland",1997,85,68108,28321,96429
"79","Finland",1997,90,38537,13351,51888
"80","Finland",1997,95,14258,3755,18013
"741","France",1998,0,1790587,1883620,3674207
"742","France",1998,5,1772686,1861132,3633818
"743","France",1998,10,1882194,1967775,3849969
"744","France",1998,15,1916093,1983924,3900017
"745","France",1998,20,1835039,1861701,3696740
"746","France",1998,25,2074773,2079330,4154103
"747","France",1998,30,2147411,2127625,4275036
"748","France",1998,35,2199833,2161578,4361411
"749","France",1998,40,2129942,2080479,4210421
"750","France",1998,45,2111696,2074355,4186051
"751","France",1998,50,2064110,2039333,4103443
"752","France",1998,55,1410479,1382118,2792597
"753","France",1998,60,1408538,1292470,2701008
"754","France",1998,65,1467873,1246872,2714745
"755","France",1998,70,1394745,1068767,2463512
"756","France",1998,75,1260385,837765,2098150
"757","France",1998,80,621229,342449,963678
"758","France",1998,85,571379,241046,812425
"759","France",1998,90,261801,79136,340937
"760","France",1998,95,68854,13970,82824
"761","Germany",2009,0,1651385,1738816,3390201
"762","Germany",2009,5,1763029,1852259,3615288
"763","Germany",2009,10,1932818,2028610,3961428
"764","Germany",2009,15,2040354,2138344,4178698
"765","Germany",2009,20,2359768,2460037,4819805
"766","Germany",2009,25,2436621,2491126,4927747
"767","Germany",2009,30,2345220,2375934,4721154
"768","Germany",2009,35,2466425,2542481,5008906
"769","Germany",2009,40,3279512,3402243,6681755
"770","Germany",2009,45,3429175,3549371,6978546
"771","Germany",2009,50,3044889,3110861,6155750
"772","Germany",2009,55,2678525,2634206,5312731
"773","Germany",2009,60,2255010,2207810,4462820
"774","Germany",2009,65,2363054,2213603,4576657
"775","Germany",2009,70,2577178,2208427,4785605
"776","Germany",2009,75,1791884,1356282,3148166
"777","Germany",2009,80,1445603,852183,2297786
"778","Germany",2009,85,960266,357397,1317663
"779","Germany",2009,90,280635,78090,358725
"780","Germany",2009,95,106836,20734,127570
"781","Greece",2005,0,263340,277378,540718
"782","Greece",2005,5,268222,277783,546005
"783","Greece",2005,10,278153,288372,566525
"784","Greece",2005,15,303790,316752,620542
"785","Greece",2005,20,384648,409049,793697
"786","Greece",2005,25,423872,448727,872599
"787","Greece",2005,30,430127,447314,877441
"788","Greece",2005,35,441042,452950,893992
"789","Greece",2005,40,407028,413645,820673
"790","Greece",2005,45,399591,400940,800531
"791","Greece",2005,50,349505,340779,690284
"792","Greece",2005,55,337768,327561,665329
"793","Greece",2005,60,266899,258854,525753
"794","Greece",2005,65,314446,279541,593987
"795","Greece",2005,70,308299,260651,568950
"796","Greece",2005,75,234094,194521,428615
"797","Greece",2005,80,146981,99805,246786
"798","Greece",2005,85,73293,41895,115188
"799","Greece",2005,90,29584,16088,45672
"800","Greece",2005,95,7701,3812,11513
"801","Haiti",1991,0,563417,579526,1142943
"802","Haiti",1991,5,520827,533767,1054594
"803","Haiti",1991,10,420449,424276,844725
"804","Haiti",1991,15,342839,336526,679365
"805","Haiti",1991,20,308290,292669,600959
"806","Haiti",1991,25,271564,252181,523745
"807","Haiti",1991,30,223599,211459,435058
"808","Haiti",1991,35,191409,177135,368544
"809","Haiti",1991,40,147794,132512,280306
"810","Haiti",1991,45,136346,126450,262796
"811","Haiti",1991,50,120247,107474,227721
"812","Haiti",1991,55,98426,87166,185592
"813","Haiti",1991,60,77608,68510,146118
"814","Haiti",1991,65,60613,53490,114103
"815","Haiti",1991,70,44938,38539,83477
"816","Haiti",1991,75,27930,23630,51560
"817","Haiti",1991,80,13888,11155,25043
"818","Haiti",1991,85,5023,3875,8898
"819","Haiti",1991,90,1188,854,2042
"820","Haiti",1991,95,201,125,326
"821","Hungary",1991,0,299996,314482,614478
"822","Hungary",1991,5,311269,325042,636311
"823","Hungary",1991,10,423599,444015,867614
"824","Hungary",1991,15,377167,397355,774522
"825","Hungary",1991,20,335105,350469,685574
"826","Hungary",1991,25,298810,305583,604393
"827","Hungary",1991,30,379902,383328,763230
"828","Hungary",1991,35,430975,429457,860432
"829","Hungary",1991,40,361392,356024,717416
"830","Hungary",1991,45,348942,332037,680979
"831","Hungary",1991,50,317879,274426,592305
"832","Hungary",1991,55,325905,278085,603990
"833","Hungary",1991,60,322280,257140,579420
"834","Hungary",1991,65,326525,234352,560877
"835","Hungary",1991,70,152748,100566,253314
"836","Hungary",1991,75,201311,117854,319165
"837","Hungary",1991,80,116391,58383,174774
"838","Hungary",1991,85,47562,20048,67610
"839","Hungary",1991,90,13715,4611,18326
"840","Hungary",1991,95,1893,512,2405
"841","Iceland",1991,0,10493,11000,21493
"842","Iceland",1991,5,10367,10826,21193
"843","Iceland",1991,10,10255,10678,20933
"844","Iceland",1991,15,10354,10853,21207
"845","Iceland",1991,20,10343,10624,20967
"846","Iceland",1991,25,10790,11012,21802
"847","Iceland",1991,30,10261,10738,20999
"848","Iceland",1991,35,9153,9718,18871
"849","Iceland",1991,40,7867,8499,16366
"850","Iceland",1991,45,6398,6515,12913
"851","Iceland",1991,50,5161,5157,10318
"852","Iceland",1991,55,5356,5279,10635
"853","Iceland",1991,60,5124,5021,10145
"854","Iceland",1991,65,4522,4231,8753
"855","Iceland",1991,70,3679,3160,6839
"856","Iceland",1991,75,2937,2244,5181
"857","Iceland",1991,80,2064,1432,3496
"858","Iceland",1991,85,1203,759,1962
"859","Iceland",1991,90,518,252,770
"860","Iceland",1991,95,142,59,201
"861","India",1991,0,58215640,63742989,121958629
"862","India",1991,5,53136475,58222330,111358805
"863","India",1991,10,47144323,51084031,98228354
"864","India",1991,15,42364282,45708609,88072891
"865","India",1991,20,37586629,40799118,78385747
"866","India",1991,25,33604689,36822747,70427436
"867","India",1991,30,29615845,32728429,62344274
"868","India",1991,35,25949197,28806823,54756020
"869","India",1991,40,20228440,21547395,41775835
"870","India",1991,45,17248459,18115499,35363958
"871","India",1991,50,15524103,15828218,31352321
"872","India",1991,55,12831997,13087498,25919495
"873","India",1991,60,9835857,10274973,20110830
"874","India",1991,65,7099086,7319942,14419028
"875","India",1991,70,4768232,4758103,9526335
"876","India",1991,75,2802539,2690493,5493032
"877","India",1991,80,1391200,1252306,2643506
"878","India",1991,85,498072,382890,880962
"879","India",1991,90,143373,74576,217949
"880","India",1991,95,31982,10410,42392
"881","Indonesia",1991,0,10888275,11364923,22253198
"882","Indonesia",1991,5,11021684,11460356,22482040
"883","Indonesia",1991,10,10506375,10885679,21392054
"884","Indonesia",1991,15,9809630,10111968,19921598
"885","Indonesia",1991,20,8897643,9141388,18039031
"886","Indonesia",1991,25,7713002,7942251,15655253
"887","Indonesia",1991,30,6502101,6688299,13190400
"888","Indonesia",1991,35,5017244,5133351,10150595
"889","Indonesia",1991,40,4054482,3866673,7921155
"890","Indonesia",1991,45,3774032,3509111,7283143
"891","Indonesia",1991,50,3425581,3205542,6631123
"892","Indonesia",1991,55,2828178,2623816,5451994
"893","Indonesia",1991,60,2172514,2022826,4195340
"894","Indonesia",1991,65,1509888,1386140,2896028
"895","Indonesia",1991,70,1055092,895698,1950790
"896","Indonesia",1991,75,691175,547534,1238709
"897","Indonesia",1991,80,342244,243986,586230
"898","Indonesia",1991,85,92109,58154,150263
"899","Indonesia",1991,90,14332,8001,22333
"900","Indonesia",1991,95,1452,669,2121
"901","Iraq",1996,0,1620051,1721180,3341231
"902","Iraq",1996,5,1435580,1515513,2951093
"903","Iraq",1996,10,1271640,1340693,2612333
"904","Iraq",1996,15,1142720,1199473,2342193
"905","Iraq",1996,20,977816,1001457,1979273
"906","Iraq",1996,25,807883,788960,1596843
"907","Iraq",1996,30,563911,520093,1084004
"908","Iraq",1996,35,431598,398411,830009
"909","Iraq",1996,40,434284,413459,847743
"910","Iraq",1996,45,263125,275634,538759
"911","Iraq",1996,50,254056,264272,518328
"912","Iraq",1996,55,216637,215054,431691
"913","Iraq",1996,60,179048,171524,350572
"914","Iraq",1996,65,140031,127188,267219
"915","Iraq",1996,70,107631,94071,201702
"916","Iraq",1996,75,78704,65144,143848
"917","Iraq",1996,80,43291,33077,76368
"918","Iraq",1996,85,16962,11823,28785
"919","Iraq",1996,90,4144,2397,6541
"920","Iraq",1996,95,537,270,807
"921","Ireland",1999,0,126617,134876,261493
"922","Ireland",1999,5,124938,131981,256919
"923","Ireland",1999,10,143011,150581,293592
"924","Ireland",1999,15,167875,176791,344666
"925","Ireland",1999,20,164275,170028,334303
"926","Ireland",1999,25,151187,153367,304554
"927","Ireland",1999,30,132530,131816,264346
"928","Ireland",1999,35,135448,132238,267686
"929","Ireland",1999,40,127490,124488,251978
"930","Ireland",1999,45,124772,123980,248752
"931","Ireland",1999,50,114749,115583,230332
"932","Ireland",1999,55,88657,90072,178729
"933","Ireland",1999,60,73981,73653,147634
"934","Ireland",1999,65,59758,59311,119069
"935","Ireland",1999,70,53663,44072,97735
"936","Ireland",1999,75,51055,35056,86111
"937","Ireland",1999,80,34858,20646,55504
"938","Ireland",1999,85,19944,9337,29281
"939","Ireland",1999,90,6371,2234,8605
"940","Ireland",1999,95,1445,361,1806
"941","Israel",2008,0,356579,375045,731624
"942","Israel",2008,5,320874,337924,658798
"943","Israel",2008,10,297924,314551,612475
"944","Israel",2008,15,271838,286245,558083
"945","Israel",2008,20,270828,278579,549407
"946","Israel",2008,25,274697,276100,550797
"947","Israel",2008,30,270965,270002,540967
"948","Israel",2008,35,247888,246693,494581
"949","Israel",2008,40,211315,207524,418839
"950","Israel",2008,45,197066,188643,385709
"951","Israel",2008,50,190875,176433,367308
"952","Israel",2008,55,200049,184043,384092
"953","Israel",2008,60,169169,156988,326157
"954","Israel",2008,65,113620,101251,214871
"955","Israel",2008,70,101102,80354,181456
"956","Israel",2008,75,92482,66171,158653
"957","Israel",2008,80,72900,45672,118572
"958","Israel",2008,85,40746,25789,66535
"959","Israel",2008,90,13620,8181,21801
"960","Israel",2008,95,3661,2060,5721
"961","Italy",1991,0,1368271,1450448,2818719
"962","Italy",1991,5,1468832,1552113,3020945
"963","Italy",1991,10,1736289,1822500,3558789
"964","Italy",1991,15,2113067,2203588,4316655
"965","Italy",1991,20,2261996,2338364,4600360
"966","Italy",1991,25,2256826,2305917,4562743
"967","Italy",1991,30,2035968,2046302,4082270
"968","Italy",1991,35,1941942,1932442,3874384
"969","Italy",1991,40,2013686,1997699,4011385
"970","Italy",1991,45,1735379,1702434,3437813
"971","Italy",1991,50,1859090,1798246,3657336
"972","Italy",1991,55,1749628,1641861,3391489
"973","Italy",1991,60,1713383,1518619,3232002
"974","Italy",1991,65,1642252,1303564,2945816
"975","Italy",1991,70,1011003,744851,1755854
"976","Italy",1991,75,1146468,753419,1899887
"977","Italy",1991,80,760159,419856,1180015
"978","Italy",1991,85,362068,155018,517086
"979","Italy",1991,90,117013,38692,155705
"980","Italy",1991,95,22284,6700,28984
"981","Jamaica",1991,0,144144,149037,293181
"982","Jamaica",1991,5,141901,144802,286703
"983","Jamaica",1991,10,130715,132401,263116
"984","Jamaica",1991,15,130047,130602,260649
"985","Jamaica",1991,20,120948,118785,239733
"986","Jamaica",1991,25,106357,100285,206642
"987","Jamaica",1991,30,86908,82106,169014
"988","Jamaica",1991,35,65560,61992,127552
"989","Jamaica",1991,40,53081,51450,104531
"990","Jamaica",1991,45,43799,43157,86956
"991","Jamaica",1991,50,37880,36644,74524
"992","Jamaica",1991,55,35339,32857,68196
"993","Jamaica",1991,60,33069,30083,63152
"994","Jamaica",1991,65,29247,25916,55163
"995","Jamaica",1991,70,24699,21441,46140
"996","Jamaica",1991,75,19524,16534,36058
"997","Jamaica",1991,80,14973,10332,25305
"998","Jamaica",1991,85,5116,4278,9394
"999","Jamaica",1991,90,2333,1214,3547
"1000","Jamaica",1991,95,203,142,345
"81","Japan",2010,0,514785.56,541074.35,1055859.91
"82","Japan",2010,5,2073564.17,2176030.23,4249594.4
"83","Japan",2010,10,2749654.28,2888429.9,5638084.18
"84","Japan",2010,15,2886473.22,3030569.89,5917043.11
"85","Japan",2010,20,2928792.15,3091219.32,6020011.47
"86","Japan",2010,25,3159032.78,3314843.09,6473875.87
"87","Japan",2010,30,3564827.93,3702994.77,7267822.7
"88","Japan",2010,35,4146929.71,4295682.71,8442612.42
"89","Japan",2010,40,4755581.56,4915108.2,9670689.76
"90","Japan",2010,45,4224733.23,4325923.72,8550656.95
"91","Japan",2010,50,3876881.74,3936573.94,7813455.68
"92","Japan",2010,55,3837738.15,3841287.16,7679025.31
"93","Japan",2010,60,4548142.77,4475440.62,9023583.39
"94","Japan",2010,65,4894822.52,4711364.43,9606186.95
"95","Japan",2010,70,4354516.61,3989324.63,8343841.24
"96","Japan",2010,75,3724191.12,3199318.8,6923509.92
"97","Japan",2010,80,3316838.79,2535392.9,5852231.69
"98","Japan",2010,85,2594020.74,1643040.03,4237060.77
"99","Japan",2010,90,1635239.37,692629.15,2327868.52
"100","Japan",2010,95,983903.34,285266.75,1269170.09
"1001","Kenya",1991,0,2237337,2270920,4508257
"1002","Kenya",1991,5,1940953,1960962,3901915
"1003","Kenya",1991,10,1615536,1625636,3241172
"1004","Kenya",1991,15,1321244,1321492,2642736
"1005","Kenya",1991,20,1055079,1045797,2100876
"1006","Kenya",1991,25,854326,838756,1693082
"1007","Kenya",1991,30,690199,673808,1364007
"1008","Kenya",1991,35,553591,535236,1088827
"1009","Kenya",1991,40,402337,387921,790258
"1010","Kenya",1991,45,278683,266219,544902
"1011","Kenya",1991,50,251215,234860,486075
"1012","Kenya",1991,55,224556,211235,435791
"1013","Kenya",1991,60,173367,164596,337963
"1014","Kenya",1991,65,125645,120698,246343
"1015","Kenya",1991,70,88807,82307,171114
"1016","Kenya",1991,75,54653,49775,104428
"1017","Kenya",1991,80,27066,22803,49869
"1018","Kenya",1991,85,8638,6179,14817
"1019","Kenya",1991,90,1229,810,2039
"1020","Kenya",1991,95,62,41,103
"1021","Latvia",1994,0,69910,73017,142927
"1022","Latvia",1994,5,94793,98774,193567
"1023","Latvia",1994,10,90135,93613,183748
"1024","Latvia",1994,15,80830,82980,163810
"1025","Latvia",1994,20,85891,89406,175297
"1026","Latvia",1994,25,81635,87011,168646
"1027","Latvia",1994,30,94120,88062,182182
"1028","Latvia",1994,35,94404,87866,182270
"1029","Latvia",1994,40,87194,79273,166467
"1030","Latvia",1994,45,79475,68676,148151
"1031","Latvia",1994,50,83393,69601,152994
"1032","Latvia",1994,55,92514,72591,165105
"1033","Latvia",1994,60,80291,58829,139120
"1034","Latvia",1994,65,83103,48173,131276
"1035","Latvia",1994,70,66078,26748,92826
"1036","Latvia",1994,75,33344,13128,46472
"1037","Latvia",1994,80,32314,11041,43355
"1038","Latvia",1994,85,16425,5245,21670
"1039","Latvia",1994,90,5702,1478,7180
"1040","Latvia",1994,95,1189,224,1413
"1041","Lithuania",2007,0,71716,75721,147437
"1042","Lithuania",2007,5,86455,91542,177997
"1043","Lithuania",2007,10,115062,120437,235499
"1044","Lithuania",2007,15,126835,131483,258318
"1045","Lithuania",2007,20,117742,121433,239175
"1046","Lithuania",2007,25,107601,107451,215052
"1047","Lithuania",2007,30,118149,114951,233100
"1048","Lithuania",2007,35,121129,117613,238742
"1049","Lithuania",2007,40,137112,129129,266241
"1050","Lithuania",2007,45,128728,116969,245697
"1051","Lithuania",2007,50,108632,94236,202868
"1052","Lithuania",2007,55,98829,78169,176998
"1053","Lithuania",2007,60,99719,72811,172530
"1054","Lithuania",2007,65,103216,67399,170615
"1055","Lithuania",2007,70,93415,53895,147310
"1056","Lithuania",2007,75,79364,35681,115045
"1057","Lithuania",2007,80,50250,17596,67846
"1058","Lithuania",2007,85,17090,5232,22322
"1059","Lithuania",2007,90,7714,1385,9099
"1060","Lithuania",2007,95,1928,440,2368
"1061","Luxembourg",2003,0,13235,14292,27527
"1062","Luxembourg",2003,5,14131,14893,29024
"1063","Luxembourg",2003,10,14021,14691,28712
"1064","Luxembourg",2003,15,13155,13592,26747
"1065","Luxembourg",2003,20,12685,13506,26191
"1066","Luxembourg",2003,25,14427,14589,29016
"1067","Luxembourg",2003,30,17213,17006,34219
"1068","Luxembourg",2003,35,19520,19547,39067
"1069","Luxembourg",2003,40,19150,19735,38885
"1070","Luxembourg",2003,45,17163,17642,34805
"1071","Luxembourg",2003,50,14844,15405,30249
"1072","Luxembourg",2003,55,12852,13538,26390
"1073","Luxembourg",2003,60,10565,10423,20988
"1074","Luxembourg",2003,65,10020,8991,19011
"1075","Luxembourg",2003,70,9355,7652,17007
"1076","Luxembourg",2003,75,8517,5991,14508
"1077","Luxembourg",2003,80,6139,2819,8958
"1078","Luxembourg",2003,85,2906,1101,4007
"1079","Luxembourg",2003,90,1555,440,1995
"1080","Luxembourg",2003,95,460,82,542
"1081","Malawi",1994,0,887205,889564,1776769
"1082","Malawi",1994,5,742338,734347,1476685
"1083","Malawi",1994,10,591145,585415,1176560
"1084","Malawi",1994,15,509591,506053,1015644
"1085","Malawi",1994,20,432870,426951,859821
"1086","Malawi",1994,25,363433,351708,715141
"1087","Malawi",1994,30,296733,290286,587019
"1088","Malawi",1994,35,240854,241111,481965
"1089","Malawi",1994,40,192735,197082,389817
"1090","Malawi",1994,45,174858,173490,348348
"1091","Malawi",1994,50,143919,138009,281928
"1092","Malawi",1994,55,115578,108174,223752
"1093","Malawi",1994,60,90179,85632,175811
"1094","Malawi",1994,65,70715,64614,135329
"1095","Malawi",1994,70,52641,44950,97591
"1096","Malawi",1994,75,35850,29327,65177
"1097","Malawi",1994,80,16185,12530,28715
"1098","Malawi",1994,85,4156,3118,7274
"1099","Malawi",1994,90,581,419,1000
"1100","Malawi",1994,95,40,32,72
"1101","Malta",2017,0,10259,11065,21324
"1102","Malta",2017,5,9782,10500,20282
"1103","Malta",2017,10,9797,10282,20079
"1104","Malta",2017,15,11692,12511,24203
"1105","Malta",2017,20,14012,15372,29384
"1106","Malta",2017,25,15524,16859,32383
"1107","Malta",2017,30,15403,16709,32112
"1108","Malta",2017,35,15014,15987,31001
"1109","Malta",2017,40,13732,14530,28262
"1110","Malta",2017,45,12328,12805,25133
"1111","Malta",2017,50,14129,14407,28536
"1112","Malta",2017,55,15448,15358,30806
"1113","Malta",2017,60,14346,14236,28582
"1114","Malta",2017,65,15297,14510,29807
"1115","Malta",2017,70,10281,9118,19399
"1116","Malta",2017,75,8196,6404,14600
"1117","Malta",2017,80,6091,3774,9865
"1118","Malta",2017,85,3447,1795,5242
"1119","Malta",2017,90,1444,630,2074
"1120","Malta",2017,95,366,119,485
"1121","Mexico",1991,0,5644559,5871413,11515972
"1122","Mexico",1991,5,5357261,5523686,10880947
"1123","Mexico",1991,10,5201015,5313328,10514343
"1124","Mexico",1991,15,4909473,4796772,9706245
"1125","Mexico",1991,20,4118284,3971678,8089962
"1126","Mexico",1991,25,3408734,3260280,6669014
"1127","Mexico",1991,30,2852595,2707765,5560360
"1128","Mexico",1991,35,2359761,2263534,4623295
"1129","Mexico",1991,40,1804146,1764801,3568947
"1130","Mexico",1991,45,1499327,1486974,2986301
"1131","Mexico",1991,50,1226698,1181699,2408397
"1132","Mexico",1991,55,1084213,990195,2074408
"1133","Mexico",1991,60,926125,809496,1735621
"1134","Mexico",1991,65,720195,617979,1338174
"1135","Mexico",1991,70,504220,399535,903755
"1136","Mexico",1991,75,382453,291349,673802
"1137","Mexico",1991,80,230844,168755,399599
"1138","Mexico",1991,85,118427,84294,202721
"1139","Mexico",1991,90,42129,28821,70950
"1140","Mexico",1991,95,12286,8036,20322
"1141","Moldova",1991,0,209006,218071,427077
"1142","Moldova",1991,5,204456,210896,415352
"1143","Moldova",1991,10,185547,190719,376266
"1144","Moldova",1991,15,169786,170712,340498
"1145","Moldova",1991,20,145239,147129,292368
"1146","Moldova",1991,25,176090,164315,340405
"1147","Moldova",1991,30,192719,182142,374861
"1148","Moldova",1991,35,176926,167050,343976
"1149","Moldova",1991,40,132226,121572,253798
"1150","Moldova",1991,45,108722,93701,202423
"1151","Moldova",1991,50,128562,107201,235763
"1152","Moldova",1991,55,112846,90891,203737
"1153","Moldova",1991,60,113691,83373,197064
"1154","Moldova",1991,65,93605,58585,152190
"1155","Moldova",1991,70,51722,31323,83045
"1156","Moldova",1991,75,47127,26227,73354
"1157","Moldova",1991,80,23262,11504,34766
"1158","Moldova",1991,85,10366,4330,14696
"1159","Moldova",1991,90,2474,854,3328
"1160","Moldova",1991,95,475,120,595
"1161","Nepal",1991,0,1510515,1571247,3081762
"1162","Nepal",1991,5,1295114,1353846,2648960
"1163","Nepal",1991,10,1117660,1172496,2290156
"1164","Nepal",1991,15,948668,986554,1935222
"1165","Nepal",1991,20,809422,816899,1626321
"1166","Nepal",1991,25,695801,678256,1374057
"1167","Nepal",1991,30,615642,593987,1209629
"1168","Nepal",1991,35,548097,529972,1078069
"1169","Nepal",1991,40,402236,381905,784141
"1170","Nepal",1991,45,367132,341293,708425
"1171","Nepal",1991,50,319782,283895,603677
"1172","Nepal",1991,55,267247,225607,492854
"1173","Nepal",1991,60,224670,180264,404934
"1174","Nepal",1991,65,170897,129254,300151
"1175","Nepal",1991,70,112799,81790,194589
"1176","Nepal",1991,75,64923,44132,109055
"1177","Nepal",1991,80,28652,18445,47097
"1178","Nepal",1991,85,8564,5180,13744
"1179","Nepal",1991,90,1543,837,2380
"1180","Nepal",1991,95,179,78,257
"101","Netherlands",2000,0,98199,103549,201748
"102","Netherlands",2000,5,381722,400021,781743
"103","Netherlands",2000,10,489200,512470,1001670
"104","Netherlands",2000,15,470039,490343,960382
"105","Netherlands",2000,20,452554,474911,927465
"106","Netherlands",2000,25,472644,483242,955886
"107","Netherlands",2000,30,581496,594775,1176271
"108","Netherlands",2000,35,642876,671528,1314404
"109","Netherlands",2000,40,645269,669674,1314943
"110","Netherlands",2000,45,599941,614400,1214341
"111","Netherlands",2000,50,559041,575390,1134431
"112","Netherlands",2000,55,562629,582697,1145326
"113","Netherlands",2000,60,423754,435692,859446
"114","Netherlands",2000,65,365334,358118,723452
"115","Netherlands",2000,70,339326,305154,644480
"116","Netherlands",2000,75,307985,242386,550371
"117","Netherlands",2000,80,276639,180613,457252
"118","Netherlands",2000,85,181173.44,92979.38,274152.82
"119","Netherlands",2000,90,112568.06,43406.13,155974.19
"120","Netherlands",2000,95,53712.99,14477.82,68190.81
"1181","New Zealand",1990,0,135085,141337,276422
"1182","New Zealand",1990,5,123922,129871,253793
"1183","New Zealand",1990,10,127404,131821,259225
"1184","New Zealand",1990,15,145610,148007,293617
"1185","New Zealand",1990,20,137842,136739,274581
"1186","New Zealand",1990,25,141895,136603,278498
"1187","New Zealand",1990,30,139835,134962,274797
"1188","New Zealand",1990,35,122763,120698,243461
"1189","New Zealand",1990,40,119004,117455,236459
"1190","New Zealand",1990,45,92617,94881,187498
"1191","New Zealand",1990,50,77834,77734,155568
"1192","New Zealand",1990,55,73372,72979,146351
"1193","New Zealand",1990,60,69333,70593,139926
"1194","New Zealand",1990,65,67496,59772,127268
"1195","New Zealand",1990,70,55205,43018,98223
"1196","New Zealand",1990,75,45266,31320,76586
"1197","New Zealand",1990,80,30104,16519,46623
"1198","New Zealand",1990,85,14311,6334,20645
"1199","New Zealand",1990,90,5453,1612,7065
"1200","New Zealand",1990,95,1284,285,1569
"1201","Nicaragua",1991,0,342303,353873,696176
"1202","Nicaragua",1991,5,322296,333574,655870
"1203","Nicaragua",1991,10,276320,284619,560939
"1204","Nicaragua",1991,15,228768,231075,459843
"1205","Nicaragua",1991,20,184878,180393,365271
"1206","Nicaragua",1991,25,157493,149731,307224
"1207","Nicaragua",1991,30,137023,129527,266550
"1208","Nicaragua",1991,35,109569,101261,210830
"1209","Nicaragua",1991,40,67577,63387,130964
"1210","Nicaragua",1991,45,62726,59506,122232
"1211","Nicaragua",1991,50,53300,50611,103911
"1212","Nicaragua",1991,55,45617,42004,87621
"1213","Nicaragua",1991,60,39473,33116,72589
"1214","Nicaragua",1991,65,31159,24909,56068
"1215","Nicaragua",1991,70,21028,16447,37475
"1216","Nicaragua",1991,75,13257,9649,22906
"1217","Nicaragua",1991,80,6888,4519,11407
"1218","Nicaragua",1991,85,2638,1574,4212
"1219","Nicaragua",1991,90,705,405,1110
"1220","Nicaragua",1991,95,164,73,237
"1221","Nigeria",1999,0,10327572,10746689,21074261
"1222","Nigeria",1999,5,8455747,8753594,17209341
"1223","Nigeria",1999,10,7397132,7640305,15037437
"1224","Nigeria",1999,15,6551030,6755604,13306634
"1225","Nigeria",1999,20,5555307,5706135,11261442
"1226","Nigeria",1999,25,4524660,4627293,9151953
"1227","Nigeria",1999,30,3655582,3698454,7354036
"1228","Nigeria",1999,35,3065286,3089866,6155152
"1229","Nigeria",1999,40,2569688,2567688,5137376
"1230","Nigeria",1999,45,2147283,2094181,4241464
"1231","Nigeria",1999,50,1827034,1800079,3627113
"1232","Nigeria",1999,55,1524175,1466863,2991038
"1233","Nigeria",1999,60,1190085,1102181,2292266
"1234","Nigeria",1999,65,858213,769690,1627903
"1235","Nigeria",1999,70,556035,481633,1037668
"1236","Nigeria",1999,75,292804,242344,535148
"1237","Nigeria",1999,80,109402,85635,195037
"1238","Nigeria",1999,85,24996,18007,43003
"1239","Nigeria",1999,90,3202,2002,5204
"1240","Nigeria",1999,95,246,131,377
"121","Norway",1990,0,28733,30325,59058
"122","Norway",1990,5,105547,110848,216395
"123","Norway",1990,10,125420,132079,257499
"124","Norway",1990,15,130823,137137,267960
"125","Norway",1990,20,156080,162977,319057
"126","Norway",1990,25,164764,173765,338529
"127","Norway",1990,30,156073,165177,321250
"128","Norway",1990,35,154894,162895,317789
"129","Norway",1990,40,148529,157198,305727
"130","Norway",1990,45,152821,162590,315411
"131","Norway",1990,50,118259,123450,241709
"132","Norway",1990,55,97176,97151,194327
"133","Norway",1990,60,95167,93466,188633
"134","Norway",1990,65,102453,96430,198883
"135","Norway",1990,70,115297,100230,215527
"136","Norway",1990,75,100525,78049,178574
"137","Norway",1990,80,83388,57121,140509
"138","Norway",1990,85,58457,32520,90977
"139","Norway",1990,90,31822,14502,46324
"140","Norway",1990,95,13517,5336,18853
"1241","Pakistan",1991,0,8975899,9466239,18442138
"1242","Pakistan",1991,5,7358176,7792162,15150338
"1243","Pakistan",1991,10,6165759,6534140,12699899
"1244","Pakistan",1991,15,5212201,5528907,10741108
"1245","Pakistan",1991,20,4546748,4820166,9366914
"1246","Pakistan",1991,25,3935872,4168259,8104131
"1247","Pakistan",1991,30,3221448,3416578,6638026
"1248","Pakistan",1991,35,2480853,2628397,5109250
"1249","Pakistan",1991,40,2169690,2377355,4547045
"1250","Pakistan",1991,45,1954935,2180160,4135095
"1251","Pakistan",1991,50,1594986,1841108,3436094
"1252","Pakistan",1991,55,1299176,1522660,2821836
"1253","Pakistan",1991,60,1023172,1232431,2255603
"1254","Pakistan",1991,65,777392,953955,1731347
"1255","Pakistan",1991,70,538905,671706,1210611
"1256","Pakistan",1991,75,327604,406556,734160
"1257","Pakistan",1991,80,160400,193129,353529
"1258","Pakistan",1991,85,62838,68553,131391
"1259","Pakistan",1991,90,17315,15737,33052
"1260","Pakistan",1991,95,3789,2562,6351
"1261","Panama",2009,0,180139,188282,368421
"1262","Panama",2009,5,172108,179212,351320
"1263","Panama",2009,10,167700,173701,341401
"1264","Panama",2009,15,158081,163527,321608
"1265","Panama",2009,20,152582,157304,309886
"1266","Panama",2009,25,145248,149430,294678
"1267","Panama",2009,30,140263,142515,282778
"1268","Panama",2009,35,133021,134034,267055
"1269","Panama",2009,40,119474,119471,238945
"1270","Panama",2009,45,103908,103106,207014
"1271","Panama",2009,50,86220,84482,170702
"1272","Panama",2009,55,69171,66699,135870
"1273","Panama",2009,60,54645,52101,106746
"1274","Panama",2009,65,43149,40465,83614
"1275","Panama",2009,70,32989,30124,63113
"1276","Panama",2009,75,23697,20931,44628
"1277","Panama",2009,80,15634,13250,28884
"1278","Panama",2009,85,8929,7252,16181
"1279","Panama",2009,90,4032,3186,7218
"1280","Panama",2009,95,1465,1164,2629
"1281","Peru",1991,0,1528392,1583520,3111912
"1282","Peru",1991,5,1409222,1455110,2864332
"1283","Peru",1991,10,1292752,1341477,2634229
"1284","Peru",1991,15,1179718,1217839,2397557
"1285","Peru",1991,20,1043432,1051195,2094627
"1286","Peru",1991,25,911046,894036,1805082
"1287","Peru",1991,30,766076,739134,1505210
"1288","Peru",1991,35,638809,607884,1246693
"1289","Peru",1991,40,504918,472145,977063
"1290","Peru",1991,45,418356,388772,807128
"1291","Peru",1991,50,362272,335016,697288
"1292","Peru",1991,55,306298,279608,585906
"1293","Peru",1991,60,243308,216765,460073
"1294","Peru",1991,65,189526,163319,352845
"1295","Peru",1991,70,135843,112386,248229
"1296","Peru",1991,75,92817,72283,165100
"1297","Peru",1991,80,49414,34972,84386
"1298","Peru",1991,85,16815,10724,27539
"1299","Peru",1991,90,3585,1988,5573
"1300","Peru",1991,95,443,218,661
"1301","Philippines",1991,0,4608770,4833220,9441990
"1302","Philippines",1991,5,4108426,4287901,8396327
"1303","Philippines",1991,10,3671391,3827501,7498892
"1304","Philippines",1991,15,3233600,3376048,6609648
"1305","Philippines",1991,20,2868630,2985562,5854192
"1306","Philippines",1991,25,2524369,2612982,5137351
"1307","Philippines",1991,30,2176116,2236364,4412480
"1308","Philippines",1991,35,1856587,1892707,3749294
"1309","Philippines",1991,40,1292468,1341257,2633725
"1310","Philippines",1991,45,1060574,1067594,2128168
"1311","Philippines",1991,50,875875,845729,1721604
"1312","Philippines",1991,55,704191,680390,1384581
"1313","Philippines",1991,60,528215,453698,981913
"1314","Philippines",1991,65,444373,343554,787927
"1315","Philippines",1991,70,315828,232065,547893
"1316","Philippines",1991,75,212872,149533,362405
"1317","Philippines",1991,80,105028,73683,178711
"1318","Philippines",1991,85,32041,23078,55119
"1319","Philippines",1991,90,6947,4540,11487
"1320","Philippines",1991,95,988,474,1462
"1321","Poland",1991,0,1436930,1509602,2946532
"1322","Poland",1991,5,1645140,1728753,3373893
"1323","Poland",1991,10,1570696,1644565,3215261
"1324","Poland",1991,15,1389473,1450684,2840157
"1325","Poland",1991,20,1225310,1276144,2501454
"1326","Poland",1991,25,1304561,1350648,2655209
"1327","Poland",1991,30,1612365,1660462,3272827
"1328","Poland",1991,35,1580403,1596278,3176681
"1329","Poland",1991,40,1346952,1336368,2683320
"1330","Poland",1991,45,908092,870566,1778658
"1331","Poland",1991,50,1023077,942220,1965297
"1332","Poland",1991,55,1047009,918366,1965375
"1333","Poland",1991,60,1006264,802100,1808364
"1334","Poland",1991,65,857663,595858,1453521
"1335","Poland",1991,70,471830,290813,762643
"1336","Poland",1991,75,517376,282319,799695
"1337","Poland",1991,80,341619,161470,503089
"1338","Poland",1991,85,145812,53909,199721
"1339","Poland",1991,90,39007,11769,50776
"1340","Poland",1991,95,6003,1717,7720
"141","Portugal",1999,0,54041,57555,111596
"142","Portugal",1999,5,208197,223077,431274
"143","Portugal",1999,10,273268,286981,560249
"144","Portugal",1999,15,291234,305322,596556
"145","Portugal",1999,20,353010,365048,718058
"146","Portugal",1999,25,402520,411372,813892
"147","Portugal",1999,30,387577,390620,778197
"148","Portugal",1999,35,380566,372052,752618
"149","Portugal",1999,40,377239,363379,740618
"150","Portugal",1999,45,356165,339856,696021
"151","Portugal",1999,50,341059,322368,663427
"152","Portugal",1999,55,321920,291114,613034
"153","Portugal",1999,60,286563,254944,541507
"154","Portugal",1999,65,298592,257757,556349
"155","Portugal",1999,70,284832,234985,519817
"156","Portugal",1999,75,249759,189924,439683
"157","Portugal",1999,80,189563,131999,321562
"158","Portugal",1999,85,126462.6,73646.71,200109.31
"159","Portugal",1999,90,74867.29,35303.62,110170.91
"160","Portugal",1999,95,29700.49,10243.13,39943.62
"1341","Romania",1990,0,885895,931489,1817384
"1342","Romania",1990,5,847883,891109,1738992
"1343","Romania",1990,10,986559,1035400,2021959
"1344","Romania",1990,15,963865,1009287,1973152
"1345","Romania",1990,20,953213,994308,1947521
"1346","Romania",1990,25,667188,695854,1363042
"1347","Romania",1990,30,843939,871772,1715711
"1348","Romania",1990,35,875270,894949,1770219
"1349","Romania",1990,40,734993,737361,1472354
"1350","Romania",1990,45,588637,577666,1166303
"1351","Romania",1990,50,760082,686642,1446724
"1352","Romania",1990,55,703106,657223,1360329
"1353","Romania",1990,60,661649,589748,1251397
"1354","Romania",1990,65,556618,430471,987089
"1355","Romania",1990,70,296762,195923,492685
"1356","Romania",1990,75,329117,212678,541795
"1357","Romania",1990,80,177594,118994,296588
"1358","Romania",1990,85,61184,39358,100542
"1359","Romania",1990,90,14325,8268,22593
"1360","Romania",1990,95,1772,1005,2777
"1361","Sierra Leone",1991,0,382321,378034,760355
"1362","Sierra Leone",1991,5,310547,307015,617562
"1363","Sierra Leone",1991,10,260133,258379,518512
"1364","Sierra Leone",1991,15,221538,219575,441113
"1365","Sierra Leone",1991,20,184964,183045,368009
"1366","Sierra Leone",1991,25,153362,150735,304097
"1367","Sierra Leone",1991,30,126254,123114,249368
"1368","Sierra Leone",1991,35,106842,103270,210112
"1369","Sierra Leone",1991,40,93921,92940,186861
"1370","Sierra Leone",1991,45,82788,81008,163796
"1371","Sierra Leone",1991,50,70557,67333,137890
"1372","Sierra Leone",1991,55,59346,54934,114280
"1373","Sierra Leone",1991,60,48246,43055,91301
"1374","Sierra Leone",1991,65,36749,31625,68374
"1375","Sierra Leone",1991,70,25027,20765,45792
"1376","Sierra Leone",1991,75,14462,11495,25957
"1377","Sierra Leone",1991,80,6646,4997,11643
"1378","Sierra Leone",1991,85,2246,1543,3789
"1379","Sierra Leone",1991,90,519,313,832
"1380","Sierra Leone",1991,95,80,40,120
"1381","Slovakia",1991,0,203583,212470,416053
"1382","Slovakia",1991,5,219190,228754,447944
"1383","Slovakia",1991,10,234503,244193,478696
"1384","Slovakia",1991,15,212461,221073,433534
"1385","Slovakia",1991,20,182188,188982,371170
"1386","Slovakia",1991,25,194398,200769,395167
"1387","Slovakia",1991,30,210155,215001,425156
"1388","Slovakia",1991,35,211326,214121,425447
"1389","Slovakia",1991,40,170909,169156,340065
"1390","Slovakia",1991,45,146844,135851,282695
"1391","Slovakia",1991,50,131039,115593,246632
"1392","Slovakia",1991,55,135154,116569,251723
"1393","Slovakia",1991,60,129885,102933,232818
"1394","Slovakia",1991,65,128269,94818,223087
"1395","Slovakia",1991,70,59914,42036,101950
"1396","Slovakia",1991,75,71639,45651,117290
"1397","Slovakia",1991,80,42431,23319,65750
"1398","Slovakia",1991,85,18200,8082,26282
"1399","Slovakia",1991,90,4506,1746,6252
"1400","Slovakia",1991,95,550,194,744
"1401","Slovenia",1998,0,43648,46370,90018
"1402","Slovenia",1998,5,48913,51548,100461
"1403","Slovenia",1998,10,59971,63075,123046
"1404","Slovenia",1998,15,68320,71485,139805
"1405","Slovenia",1998,20,72816,79156,151972
"1406","Slovenia",1998,25,68683,74280,142963
"1407","Slovenia",1998,30,74689,76118,150807
"1408","Slovenia",1998,35,76245,77871,154116
"1409","Slovenia",1998,40,76625,80858,157483
"1410","Slovenia",1998,45,77426,83398,160824
"1411","Slovenia",1998,50,59817,61609,121426
"1412","Slovenia",1998,55,56854,54778,111632
"1413","Slovenia",1998,60,53984,48708,102692
"1414","Slovenia",1998,65,55616,42560,98176
"1415","Slovenia",1998,70,49352,30148,79500
"1416","Slovenia",1998,75,40146,17713,57859
"1417","Slovenia",1998,80,14732,6108,20840
"1418","Slovenia",1998,85,13222,4870,18092
"1419","Slovenia",1998,90,4038,1206,5244
"1420","Slovenia",1998,95,609,145,754
"1421","South Africa",1991,0,2685044,2744303,5429347
"1422","South Africa",1991,5,2498492,2547294,5045786
"1423","South Africa",1991,10,2128835,2160492,4289327
"1424","South Africa",1991,15,1894810,1903381,3798191
"1425","South Africa",1991,20,1643882,1629359,3273241
"1426","South Africa",1991,25,1439382,1412513,2851895
"1427","South Africa",1991,30,1245780,1214922,2460702
"1428","South Africa",1991,35,1066858,1038139,2104997
"1429","South Africa",1991,40,828670,810048,1638718
"1430","South Africa",1991,45,726471,708337,1434808
"1431","South Africa",1991,50,616156,583014,1199170
"1432","South Africa",1991,55,511862,489325,1001187
"1433","South Africa",1991,60,421529,391797,813326
"1434","South Africa",1991,65,326404,286729,613133
"1435","South Africa",1991,70,244611,197498,442109
"1436","South Africa",1991,75,145022,110969,255991
"1437","South Africa",1991,80,69649,45652,115301
"1438","South Africa",1991,85,18495,10884,29379
"1439","South Africa",1991,90,2541,1200,3741
"1440","South Africa",1991,95,107,51,158
"1441","South Korea",1990,0,1458436,1659821,3118257
"1442","South Korea",1990,5,1851769,1979113,3830882
"1443","South Korea",1990,10,1925327,2042954,3968281
"1444","South Korea",1990,15,2155436,2295505,4450941
"1445","South Korea",1990,20,2151206,2258218,4409424
"1446","South Korea",1990,25,2111743,2197151,4308894
"1447","South Korea",1990,30,2021580,2107102,4128682
"1448","South Korea",1990,35,1494451,1548196,3042647
"1449","South Korea",1990,40,1227251,1332334,2559585
"1450","South Korea",1990,45,1063572,1074784,2138356
"1451","South Korea",1990,50,993539,991573,1985112
"1452","South Korea",1990,55,871309,709510,1580819
"1453","South Korea",1990,60,665164,485451,1150615
"1454","South Korea",1990,65,555031,387639,942670
"1455","South Korea",1990,70,372126,237337,609463
"1456","South Korea",1990,75,259384,128610,387994
"1457","South Korea",1990,80,145058,58808,203866
"1458","South Korea",1990,85,57590,15656,73246
"1459","South Korea",1990,90,20023,3849,23872
"1460","South Korea",1990,95,4273,537,4810
"161","Spain",2005,0,220123,235081,455204
"162","Spain",2005,5,840853,887789,1728642
"163","Spain",2005,10,963463,1016029,1979492
"164","Spain",2005,15,1019628,1078737,2098365
"165","Spain",2005,20,1133436,1197781,2331217
"166","Spain",2005,25,1455778,1530883,2986661
"167","Spain",2005,30,1819545,1940189,3759734
"168","Spain",2005,35,1813498,1933425,3746923
"169","Spain",2005,40,1755064,1826068,3581132
"170","Spain",2005,45,1666123,1692347,3358470
"171","Spain",2005,50,1492256,1489063,2981319
"172","Spain",2005,55,1286202,1266570,2552772
"173","Spain",2005,60,1251697,1198137,2449834
"174","Spain",2005,65,1094069,1022620,2116689
"175","Spain",2005,70,984202,861065,1845267
"176","Spain",2005,75,1072866,880021,1952887
"177","Spain",2005,80,899162,651199,1550361
"178","Spain",2005,85,671964.8,405321.74,1077286.54
"179","Spain",2005,90,355463.38,160665.6,516128.98
"180","Spain",2005,95,197079.21,69723.66,266802.87
"1461","Suriname",1999,0,25902,27748,53650
"1462","Suriname",1999,5,25329,26446,51775
"1463","Suriname",1999,10,23542,25071,48613
"1464","Suriname",1999,15,21783,22255,44038
"1465","Suriname",1999,20,19086,19825,38911
"1466","Suriname",1999,25,20551,21167,41718
"1467","Suriname",1999,30,18087,19395,37482
"1468","Suriname",1999,35,18304,18989,37293
"1469","Suriname",1999,40,12919,13664,26583
"1470","Suriname",1999,45,10444,10018,20462
"1471","Suriname",1999,50,9007,8504,17511
"1472","Suriname",1999,55,7638,6546,14184
"1473","Suriname",1999,60,6825,6042,12867
"1474","Suriname",1999,65,5127,4941,10068
"1475","Suriname",1999,70,3872,3674,7546
"1476","Suriname",1999,75,2317,2145,4462
"1477","Suriname",1999,80,1344,890,2234
"1478","Suriname",1999,85,640,407,1047
"1479","Suriname",1999,90,256,126,382
"1480","Suriname",1999,95,86,32,118
"181","Sweden",1990,0,56317,59530,115847
"182","Sweden",1990,5,206302,217618,423920
"183","Sweden",1990,10,235279,247921,483200
"184","Sweden",1990,15,243300,255579,498879
"185","Sweden",1990,20,276583,289888,566471
"186","Sweden",1990,25,297937,314571,612508
"187","Sweden",1990,30,287767,304284,592051
"188","Sweden",1990,35,281764,296079,577843
"189","Sweden",1990,40,288806,301270,590076
"190","Sweden",1990,45,327770,340063,667833
"191","Sweden",1990,50,280393,294955,575348
"192","Sweden",1990,55,225956,229891,455847
"193","Sweden",1990,60,213226,206251,419477
"194","Sweden",1990,65,222788,207328,430116
"195","Sweden",1990,70,243695,216371,460066
"196","Sweden",1990,75,207294,170521,377815
"197","Sweden",1990,80,185616,135186,320802
"198","Sweden",1990,85,134314.12,80694.59,215008.71
"199","Sweden",1990,90,70899.15,33559,104458.15
"200","Sweden",1990,95,28865,10476,39341
"201","Switzerland",1991,0,40760,42511,83271
"202","Switzerland",1991,5,152985,160386,313371
"203","Switzerland",1991,10,187628,196331,383959
"204","Switzerland",1991,15,184654,193200,377854
"205","Switzerland",1991,20,205056,216195,421251
"206","Switzerland",1991,25,251256,254760,506016
"207","Switzerland",1991,30,278037,284233,562270
"208","Switzerland",1991,35,262801,272599,535400
"209","Switzerland",1991,40,248302,255051,503353
"210","Switzerland",1991,45,253197,260053,513250
"211","Switzerland",1991,50,235307,241828,477135
"212","Switzerland",1991,55,198584,197148,395732
"213","Switzerland",1991,60,186498,178848,365346
"214","Switzerland",1991,65,175519,153614,329133
"215","Switzerland",1991,70,165196,132531,297727
"216","Switzerland",1991,75,131650,99833,231483
"217","Switzerland",1991,80,123989,79926,203915
"218","Switzerland",1991,85,96249.09,50756,147005.09
"219","Switzerland",1991,90,52707,21999,74706
"220","Switzerland",1991,95,21427,6545,27972
"1481","Taiwan",2017,0,494049,532165,1026214
"1482","Taiwan",2017,5,466326,506643,972969
"1483","Taiwan",2017,10,579794,631657,1211451
"1484","Taiwan",2017,15,720743,783010,1503753
"1485","Taiwan",2017,20,773409,834084,1607493
"1486","Taiwan",2017,25,782167,820515,1602682
"1487","Taiwan",2017,30,954502,971047,1925549
"1488","Taiwan",2017,35,1024644,1012652,2037296
"1489","Taiwan",2017,40,888487,884727,1773214
"1490","Taiwan",2017,45,919834,913374,1833208
"1491","Taiwan",2017,50,960957,926754,1887711
"1492","Taiwan",2017,55,879493,857820,1737313
"1493","Taiwan",2017,60,775971,714571,1490542
"1494","Taiwan",2017,65,497646,483395,981041
"1495","Taiwan",2017,70,369221,300438,669659
"1496","Taiwan",2017,75,308619,240726,549345
"1497","Taiwan",2017,80,209360,191487,400847
"1498","Taiwan",2017,85,123336,109971,233307
"1499","Taiwan",2017,90,49632,41803,91435
"1500","Taiwan",2017,95,13302,9142,22444
"1501","Togo",1991,0,335731,335486,671217
"1502","Togo",1991,5,289422,287412,576834
"1503","Togo",1991,10,246066,243944,490010
"1504","Togo",1991,15,203830,201289,405119
"1505","Togo",1991,20,165409,162129,327538
"1506","Togo",1991,25,134291,130874,265165
"1507","Togo",1991,30,109564,106544,216108
"1508","Togo",1991,35,91066,88390,179456
"1509","Togo",1991,40,76590,73898,150488
"1510","Togo",1991,45,64114,61691,125805
"1511","Togo",1991,50,53649,49808,103457
"1512","Togo",1991,55,44178,39897,84075
"1513","Togo",1991,60,35611,30988,66599
"1514","Togo",1991,65,27270,22653,49923
"1515","Togo",1991,70,18899,14950,33849
"1516","Togo",1991,75,11047,7972,19019
"1517","Togo",1991,80,4493,3010,7503
"1518","Togo",1991,85,1159,711,1870
"1519","Togo",1991,90,167,88,255
"1520","Togo",1991,95,14,6,20
"1521","Turkey",1991,0,3242545,3338455,6581000
"1522","Turkey",1991,5,3238060,3312396,6550456
"1523","Turkey",1991,10,3064799,3104149,6168948
"1524","Turkey",1991,15,2812027,2798195,5610222
"1525","Turkey",1991,20,2476960,2454255,4931215
"1526","Turkey",1991,25,2214851,2140396,4355247
"1527","Turkey",1991,30,1983076,1822028,3805104
"1528","Turkey",1991,35,1725695,1537395,3263090
"1529","Turkey",1991,40,1342646,1252928,2595574
"1530","Turkey",1991,45,1118382,1091899,2210281
"1531","Turkey",1991,50,962791,1049367,2012158
"1532","Turkey",1991,55,931848,989193,1921041
"1533","Turkey",1991,60,745419,688225,1433644
"1534","Turkey",1991,65,529090,445167,974257
"1535","Turkey",1991,70,355715,252544,608259
"1536","Turkey",1991,75,286603,226147,512750
"1537","Turkey",1991,80,175725,92664,268389
"1538","Turkey",1991,85,63210,29896,93106
"1539","Turkey",1991,90,19515,4664,24179
"1540","Turkey",1991,95,2537,301,2838
"1541","Ukraine",2016,0,1202143,1276442,2478585
"1542","Ukraine",2016,5,1167126,1238967,2406093
"1543","Ukraine",2016,10,956642,1015489,1972131
"1544","Ukraine",2016,15,1044196,1098319,2142515
"1545","Ukraine",2016,20,1345715,1416579,2762294
"1546","Ukraine",2016,25,1767448,1848850,3616298
"1547","Ukraine",2016,30,1808299,1868429,3676728
"1548","Ukraine",2016,35,1727853,1674968,3402821
"1549","Ukraine",2016,40,1617402,1533126,3150528
"1550","Ukraine",2016,45,1532138,1375890,2908028
"1551","Ukraine",2016,50,1772311,1501934,3274245
"1552","Ukraine",2016,55,1778179,1391720,3169899
"1553","Ukraine",2016,60,1727994,1194519,2922513
"1554","Ukraine",2016,65,1279429,817023,2096452
"1555","Ukraine",2016,70,1035045,556977,1592022
"1556","Ukraine",2016,75,1254855,575074,1829929
"1557","Ukraine",2016,80,576566,244029,820595
"1558","Ukraine",2016,85,418694,126805,545499
"1559","Ukraine",2016,90,111218,23958,135176
"1560","Ukraine",2016,95,16419,2866,19285
"1561","United Kingdom",1997,0,1860457,1952245,3812702
"1562","United Kingdom",1997,5,1873334,1959647,3832981
"1563","United Kingdom",1997,10,1775209,1854433,3629642
"1564","United Kingdom",1997,15,1675323,1725657,3400980
"1565","United Kingdom",1997,20,1935447,1963857,3899304
"1566","United Kingdom",1997,25,2289891,2274758,4564649
"1567","United Kingdom",1997,30,2347647,2315071,4662718
"1568","United Kingdom",1997,35,2021013,1990725,4011738
"1569","United Kingdom",1997,40,1861179,1842172,3703351
"1570","United Kingdom",1997,45,2038319,2021961,4060280
"1571","United Kingdom",1997,50,1676641,1659265,3335906
"1572","United Kingdom",1997,55,1519968,1484769,3004737
"1573","United Kingdom",1997,60,1435736,1373333,2809069
"1574","United Kingdom",1997,65,1416497,1255174,2671671
"1575","United Kingdom",1997,70,1390566,1089633,2480199
"1576","United Kingdom",1997,75,1050200,698218,1748418
"1577","United Kingdom",1997,80,857851,456102,1313953
"1578","United Kingdom",1997,85,502261,193256,695517
"1579","United Kingdom",1997,90,191681,49802,241483
"1580","United Kingdom",1997,95,45739,7413,53152
"1581","Uruguay",1998,0,132075,138013,270088
"1582","Uruguay",1998,5,136344,142246,278590
"1583","Uruguay",1998,10,130223,135737,265960
"1584","Uruguay",1998,15,124945,129746,254691
"1585","Uruguay",1998,20,133108,137198,270306
"1586","Uruguay",1998,25,123715,126894,250609
"1587","Uruguay",1998,30,110805,108960,219765
"1588","Uruguay",1998,35,111810,106151,217961
"1589","Uruguay",1998,40,106853,99956,206809
"1590","Uruguay",1998,45,94698,89663,184361
"1591","Uruguay",1998,50,88646,80956,169602
"1592","Uruguay",1998,55,81596,72995,154591
"1593","Uruguay",1998,60,77396,64389,141785
"1594","Uruguay",1998,65,76050,60899,136949
"1595","Uruguay",1998,70,68728,49207,117935
"1596","Uruguay",1998,75,52248,33210,85458
"1597","Uruguay",1998,80,33601,17895,51496
"1598","Uruguay",1998,85,20272,8804,29076
"1599","Uruguay",1998,90,7475,2892,10367
"1600","Uruguay",1998,95,2488,847,3335
"1601","USA",1998,0,9563676,10000905,19564581
"1602","USA",1998,5,10176500,10671510,20848010
"1603","USA",1998,10,10119062,10607728,20726790
"1604","USA",1998,15,9710357,10223642,19933999
"1605","USA",1998,20,9329933,9705899,19035832
"1606","USA",1998,25,9523399,9761952,19285351
"1607","USA",1998,30,10096342,10517304,20613646
"1608","USA",1998,35,11126992,11448082,22575074
"1609","USA",1998,40,11187667,11213322,22400989
"1610","USA",1998,45,10213431,10037915,20251346
"1611","USA",1998,50,8959431,8544729,17504160
"1612","USA",1998,55,6944267,6375046,13319313
"1613","USA",1998,60,5643768,5262559,10906327
"1614","USA",1998,65,5071324,4378558,9449882
"1615","USA",1998,70,4902578,3878913,8781491
"1616","USA",1998,75,4325729,3053384,7379113
"1617","USA",1998,80,3126458,1883372,5009830
"1618","USA",1998,85,1806518,858119,2664637
"1619","USA",1998,90,854111,274235,1128346
"1620","USA",1998,95,267783,64414,332197
