"","Country","Year","Age","Female","Male","Total"
"221","Afghanistan",2002,0,2042084,2124163,4166247
"222","Afghanistan",2002,5,1603445,1688904,3292349
"223","Afghanistan",2002,10,1296308,1405116,2701424
"224","Afghanistan",2002,15,1042985,1149709,2192694
"225","Afghanistan",2002,20,831930,921620,1753550
"226","Afghanistan",2002,25,680892,734778,1415670
"227","Afghanistan",2002,30,562956,599498,1162454
"228","Afghanistan",2002,35,461895,492828,954723
"229","Afghanistan",2002,40,381650,405623,787273
"230","Afghanistan",2002,45,314363,329054,643417
"231","Afghanistan",2002,50,279119,259969,539088
"232","Afghanistan",2002,55,198274,203128,401402
"233","Afghanistan",2002,60,147831,145570,293401
"234","Afghanistan",2002,65,105589,100139,205728
"235","Afghanistan",2002,70,72078,69663,141741
"236","Afghanistan",2002,75,43206,38817,82023
"237","Afghanistan",2002,80,18798,15536,34334
"238","Afghanistan",2002,85,5957,4631,10588
"239","Afghanistan",2002,90,1007,708,1715
"240","Afghanistan",2002,95,82,54,136
"241","Albania",2004,0,103875,115530,219405
"242","Albania",2004,5,133244,145086,278330
"243","Albania",2004,10,154756,165542,320298
"244","Albania",2004,15,157519,160435,317954
"245","Albania",2004,20,129889,120160,250049
"246","Albania",2004,25,102159,89462,191621
"247","Albania",2004,30,98333,89306,187639
"248","Albania",2004,35,106503,96565,203068
"249","Albania",2004,40,113556,109736,223292
"250","Albania",2004,45,101157,106738,207895
"251","Albania",2004,50,81951,89766,171717
"252","Albania",2004,55,63160,73122,136282
"253","Albania",2004,60,53675,63186,116861
"254","Albania",2004,65,47950,52506,100456
"255","Albania",2004,70,35861,37281,73142
"256","Albania",2004,75,26293,23381,49674
"257","Albania",2004,80,15143,9199,24342
"258","Albania",2004,85,7280,3938,11218
"259","Albania",2004,90,2215,925,3140
"260","Albania",2004,95,316,111,427
"261","Algeria",2004,0,1448491,1511790,2960281
"262","Algeria",2004,5,1492318,1557547,3049865
"263","Algeria",2004,10,1795465,1871701,3667166
"264","Algeria",2004,15,1898141,1976991,3875132
"265","Algeria",2004,20,1832662,1895844,3728506
"266","Algeria",2004,25,1591606,1630248,3221854
"267","Algeria",2004,30,1302658,1313987,2616645
"268","Algeria",2004,35,1096734,1103824,2200558
"269","Algeria",2004,40,930605,947386,1877991
"270","Algeria",2004,45,745237,775237,1520474
"271","Algeria",2004,50,621137,644025,1265162
"272","Algeria",2004,55,418559,419734,838293
"273","Algeria",2004,60,354174,342834,697008
"274","Algeria",2004,65,319458,294140,613598
"275","Algeria",2004,70,249200,232815,482015
"276","Algeria",2004,75,159125,141564,300689
"277","Algeria",2004,80,79849,68993,148842
"278","Algeria",2004,85,37063,29153,66216
"279","Algeria",2004,90,9584,7112,16696
"280","Algeria",2004,95,1627,1102,2729
"281","Argentina",2005,0,1746941,1811375,3558316
"282","Argentina",2005,5,1718833,1779644,3498477
"283","Argentina",2005,10,1750656,1802547,3553203
"284","Argentina",2005,15,1677183,1710634,3387817
"285","Argentina",2005,20,1598428,1603933,3202361
"286","Argentina",2005,25,1606414,1574838,3181252
"287","Argentina",2005,30,1398914,1325045,2723959
"288","Argentina",2005,35,1244600,1165185,2409785
"289","Argentina",2005,40,1181876,1098461,2280337
"290","Argentina",2005,45,1088917,1018646,2107563
"291","Argentina",2005,50,1011944,946834,1958778
"292","Argentina",2005,55,907081,836422,1743503
"293","Argentina",2005,60,766561,673968,1440529
"294","Argentina",2005,65,654925,538531,1193456
"295","Argentina",2005,70,580137,432950,1013087
"296","Argentina",2005,75,490040,307828,797868
"297","Argentina",2005,80,329967,174265,504232
"298","Argentina",2005,85,168880,71858,240738
"299","Argentina",2005,90,60749,20799,81548
"300","Argentina",2005,95,12513,3602,16115
"301","Australia",1995,0,631901,665916,1297817
"302","Australia",1995,5,629487,661686,1291173
"303","Australia",1995,10,629747,662431,1292178
"304","Australia",1995,15,618821,651258,1270079
"305","Australia",1995,20,697620,718531,1416151
"306","Australia",1995,25,687563,690722,1378285
"307","Australia",1995,30,729612,728193,1457805
"308","Australia",1995,35,712243,709752,1421995
"309","Australia",1995,40,666358,665105,1331463
"310","Australia",1995,45,615551,633275,1248826
"311","Australia",1995,50,469190,488163,957353
"312","Australia",1995,55,391191,401320,792511
"313","Australia",1995,60,353380,350617,703997
"314","Australia",1995,65,350825,331204,682029
"315","Australia",1995,70,319405,266802,586207
"316","Australia",1995,75,233790,170359,404149
"317","Australia",1995,80,174383,102170,276553
"318","Australia",1995,85,89516,41145,130661
"319","Australia",1995,90,32854,10607,43461
"320","Australia",1995,95,8610,1780,10390
"321","Austria",2004,0,193920,204207,398127
"322","Austria",2004,5,210315,221292,431607
"323","Austria",2004,10,237926,250594,488520
"324","Austria",2004,15,239891,250903,490794
"325","Austria",2004,20,257698,264894,522592
"326","Austria",2004,25,252484,255050,507534
"327","Austria",2004,30,292361,292224,584585
"328","Austria",2004,35,349587,356029,705616
"329","Austria",2004,40,349884,360425,710309
"330","Austria",2004,45,306281,309157,615438
"331","Austria",2004,50,250738,246120,496858
"332","Austria",2004,55,243152,234863,478015
"333","Austria",2004,60,252369,234422,486791
"334","Austria",2004,65,206766,182075,388841
"335","Austria",2004,70,169321,136182,305503
"336","Austria",2004,75,172830,111979,284809
"337","Austria",2004,80,156595,68200,224795
"338","Austria",2004,85,59962,21963,81925
"339","Austria",2004,90,32242,9753,41995
"340","Austria",2004,95,7275,1727,9002
"341","Bangladesh",2003,0,7912821,8243886,16156707
"342","Bangladesh",2003,5,7850661,8169186,16019847
"343","Bangladesh",2003,10,7647035,7955363,15602398
"344","Bangladesh",2003,15,7320065,7637519,14957584
"345","Bangladesh",2003,20,6782258,7008587,13790845
"346","Bangladesh",2003,25,6098336,6167667,12266003
"347","Bangladesh",2003,30,5199427,5282492,10481919
"348","Bangladesh",2003,35,4561363,4813483,9374846
"349","Bangladesh",2003,40,3773972,4098900,7872872
"350","Bangladesh",2003,45,2632738,2990302,5623040
"351","Bangladesh",2003,50,1803913,2090763,3894676
"352","Bangladesh",2003,55,1786754,1961115,3747869
"353","Bangladesh",2003,60,1572421,1690579,3263000
"354","Bangladesh",2003,65,1157964,1279623,2437587
"355","Bangladesh",2003,70,809091,890092,1699183
"356","Bangladesh",2003,75,525275,548591,1073866
"357","Bangladesh",2003,80,267443,277777,545220
"358","Bangladesh",2003,85,89971,94538,184509
"359","Bangladesh",2003,90,19417,18732,38149
"360","Bangladesh",2003,95,2986,2399,5385
"1","Belgium",2003,0,54245,57076,111321
"2","Belgium",2003,5,225844,235491,461335
"3","Belgium",2003,10,290870,303988,594858
"4","Belgium",2003,15,310278,324907,635185
"5","Belgium",2003,20,295749,308920,604669
"6","Belgium",2003,25,319540,326231,645771
"7","Belgium",2003,30,324117,330683,654800
"8","Belgium",2003,35,365635,374781,740416
"9","Belgium",2003,40,394835,407125,801960
"10","Belgium",2003,45,396665,404869,801534
"11","Belgium",2003,50,370937,375847,746784
"12","Belgium",2003,55,343888,348258,692146
"13","Belgium",2003,60,307572,305293,612865
"14","Belgium",2003,65,252118,237692,489810
"15","Belgium",2003,70,261097,231550,492647
"16","Belgium",2003,75,264370,209282,473652
"17","Belgium",2003,80,228956,155037,383993
"18","Belgium",2003,85,156543.29,86004.3,242547.59
"19","Belgium",2003,90,76978.37,30714.48,107692.85
"20","Belgium",2003,95,48592.16,12848.6,61440.76
"361","Bolivia",2004,0,583370,608803,1192173
"362","Bolivia",2004,5,548990,571668,1120658
"363","Bolivia",2004,10,509822,531129,1040951
"364","Bolivia",2004,15,462956,480857,943813
"365","Bolivia",2004,20,410485,424563,835048
"366","Bolivia",2004,25,361524,369335,730859
"367","Bolivia",2004,30,311195,316130,627325
"368","Bolivia",2004,35,265739,268233,533972
"369","Bolivia",2004,40,226719,227172,453891
"370","Bolivia",2004,45,194117,192298,386415
"371","Bolivia",2004,50,167807,163920,331727
"372","Bolivia",2004,55,144057,139978,284035
"373","Bolivia",2004,60,119342,114230,233572
"374","Bolivia",2004,65,93852,86869,180721
"375","Bolivia",2004,70,75896,67203,143099
"376","Bolivia",2004,75,56069,46691,102760
"377","Bolivia",2004,80,32967,25198,58165
"378","Bolivia",2004,85,13994,10073,24067
"379","Bolivia",2004,90,4726,2697,7423
"380","Bolivia",2004,95,1151,476,1627
"381","Brazil",2004,0,8003215,8332011,16335226
"382","Brazil",2004,5,8505479,8833692,17339171
"383","Brazil",2004,10,8474700,8778484,17253184
"384","Brazil",2004,15,8654623,8896344,17550967
"385","Brazil",2004,20,8846433,8964102,17810535
"386","Brazil",2004,25,8102370,8084961,16187331
"387","Brazil",2004,30,7272560,7141753,14414313
"388","Brazil",2004,35,6927168,6698411,13625579
"389","Brazil",2004,40,6464381,6172081,12636462
"390","Brazil",2004,45,5514447,5201589,10716036
"391","Brazil",2004,50,4619897,4298312,8918209
"392","Brazil",2004,55,3635601,3314561,6950162
"393","Brazil",2004,60,2765584,2446519,5212103
"394","Brazil",2004,65,2305666,1948836,4254502
"395","Brazil",2004,70,1661721,1312119,2973840
"396","Brazil",2004,75,1220185,879583,2099768
"397","Brazil",2004,80,692684,448881,1141565
"398","Brazil",2004,85,318819,182322,501141
"399","Brazil",2004,90,113833,56335,170168
"400","Brazil",2004,95,25650,11196,36846
"401","Burkina Faso",2004,0,1221760,1264518,2486278
"402","Burkina Faso",2004,5,1000153,1032637,2032790
"403","Burkina Faso",2004,10,847038,874543,1721581
"404","Burkina Faso",2004,15,724044,745676,1469720
"405","Burkina Faso",2004,20,618329,630026,1248355
"406","Burkina Faso",2004,25,506820,504783,1011603
"407","Burkina Faso",2004,30,403306,389184,792490
"408","Burkina Faso",2004,35,332623,308810,641433
"409","Burkina Faso",2004,40,269670,236804,506474
"410","Burkina Faso",2004,45,220798,180276,401074
"411","Burkina Faso",2004,50,178368,133571,311939
"412","Burkina Faso",2004,55,145345,105328,250673
"413","Burkina Faso",2004,60,120541,82595,203136
"414","Burkina Faso",2004,65,90854,59065,149919
"415","Burkina Faso",2004,70,62263,38737,101000
"416","Burkina Faso",2004,75,36825,22665,59490
"417","Burkina Faso",2004,80,16094,9851,25945
"418","Burkina Faso",2004,85,4397,2571,6968
"419","Burkina Faso",2004,90,653,340,993
"420","Burkina Faso",2004,95,51,23,74
"421","Cameroon",2004,0,1504946,1532463,3037409
"422","Cameroon",2004,5,1258078,1277027,2535105
"423","Cameroon",2004,10,1124125,1137786,2261911
"424","Cameroon",2004,15,1002534,1011852,2014386
"425","Cameroon",2004,20,847152,851873,1699025
"426","Cameroon",2004,25,676799,678180,1354979
"427","Cameroon",2004,30,541041,539828,1080869
"428","Cameroon",2004,35,433320,430376,863696
"429","Cameroon",2004,40,347505,341317,688822
"430","Cameroon",2004,45,280380,270110,550490
"431","Cameroon",2004,50,234534,220588,455122
"432","Cameroon",2004,55,191929,174040,365969
"433","Cameroon",2004,60,155262,136287,291549
"434","Cameroon",2004,65,123439,103742,227181
"435","Cameroon",2004,70,87888,69906,157794
"436","Cameroon",2004,75,53670,39690,93360
"437","Cameroon",2004,80,25107,16968,42075
"438","Cameroon",2004,85,7388,4526,11914
"439","Cameroon",2004,90,1062,584,1646
"440","Cameroon",2004,95,70,36,106
"441","Canada",2005,0,831614,879050,1710664
"442","Canada",2005,5,907289,952912,1860201
"443","Canada",2005,10,1032916,1081565,2114481
"444","Canada",2005,15,1054491,1116920,2171411
"445","Canada",2005,20,1087810,1130826,2218636
"446","Canada",2005,25,1064803,1092340,2157143
"447","Canada",2005,30,1079765,1097179,2176944
"448","Canada",2005,35,1163223,1186645,2349868
"449","Canada",2005,40,1358369,1381020,2739389
"450","Canada",2005,45,1304687,1305446,2610133
"451","Canada",2005,50,1162716,1143750,2306466
"452","Canada",2005,55,1010927,989552,2000479
"453","Canada",2005,60,777628,751696,1529324
"454","Canada",2005,65,621991,577344,1199335
"455","Canada",2005,70,554866,489506,1044372
"456","Canada",2005,75,485032,377661,862693
"457","Canada",2005,80,385873,245003,630876
"458","Canada",2005,85,214234,105627,319861
"459","Canada",2005,90,93771,34645,128416
"460","Canada",2005,95,26864,6757,33621
"461","Chad",2015,0,1308690,1324323,2633013
"462","Chad",2015,5,1112319,1117813,2230132
"463","Chad",2015,10,941667,945408,1887075
"464","Chad",2015,15,780794,788441,1569235
"465","Chad",2015,20,639337,642970,1282307
"466","Chad",2015,25,513363,514864,1028227
"467","Chad",2015,30,407748,410136,817884
"468","Chad",2015,35,320540,323940,644480
"469","Chad",2015,40,250386,250368,500754
"470","Chad",2015,45,195088,190403,385491
"471","Chad",2015,50,162088,152657,314745
"472","Chad",2015,55,137286,124070,261356
"473","Chad",2015,60,113461,97843,211304
"474","Chad",2015,65,75350,67106,142456
"475","Chad",2015,70,53294,46449,99743
"476","Chad",2015,75,33240,27421,60661
"477","Chad",2015,80,16749,12522,29271
"478","Chad",2015,85,6122,4087,10209
"479","Chad",2015,90,1487,819,2306
"480","Chad",2015,95,228,94,322
"481","Chile",2004,0,594016,616654,1210670
"482","Chile",2004,5,649341,673452,1322793
"483","Chile",2004,10,716093,741874,1457967
"484","Chile",2004,15,695152,718478,1413630
"485","Chile",2004,20,643496,661300,1304796
"486","Chile",2004,25,629626,640012,1269638
"487","Chile",2004,30,616320,618039,1234359
"488","Chile",2004,35,614503,607063,1221566
"489","Chile",2004,40,595684,579062,1174746
"490","Chile",2004,45,536859,512445,1049304
"491","Chile",2004,50,468657,437769,906426
"492","Chile",2004,55,363722,334230,697952
"493","Chile",2004,60,296255,257765,554020
"494","Chile",2004,65,246089,199711,445800
"495","Chile",2004,70,210192,156647,366839
"496","Chile",2004,75,171486,116021,287507
"497","Chile",2004,80,99104,57955,157059
"498","Chile",2004,85,48716,24378,73094
"499","Chile",2004,90,18984,8162,27146
"500","Chile",2004,95,5543,1858,7401
"501","China",2004,0,38582614,44543000,83125614
"502","China",2004,5,41359081,46839404,88198485
"503","China",2004,10,47158082,52376718,99534800
"504","China",2004,15,63226933,67692585,130919518
"505","China",2004,20,49592564,52514052,102106616
"506","China",2004,25,47851059,50550037,98401096
"507","China",2004,30,59874755,63015648,122890403
"508","China",2004,35,62786771,64954638,127741409
"509","China",2004,40,50836825,53199554,104036379
"510","China",2004,45,41311510,43240775,84552285
"511","China",2004,50,42397299,44074906,86472205
"512","China",2004,55,29254430,30194099,59448529
"513","China",2004,60,21184996,22589089,43774085
"514","China",2004,65,18350002,19307104,37657106
"515","China",2004,70,14911884,14347328,29259212
"516","China",2004,75,9762460,8315499,18077959
"517","China",2004,80,5510687,3853488,9364175
"518","China",2004,85,2502904,1509372,4012276
"519","China",2004,90,710275,327890,1038165
"520","China",2004,95,125349,40714,166063
"521","Colombia",2003,0,2057277,2149926,4207203
"522","Colombia",2003,5,2119995,2212133,4332128
"523","Colombia",2003,10,2150301,2241613,4391914
"524","Colombia",2003,15,2012125,2082302,4094427
"525","Colombia",2003,20,1915656,1923595,3839251
"526","Colombia",2003,25,1799887,1721514,3521401
"527","Colombia",2003,30,1643758,1488846,3132604
"528","Colombia",2003,35,1586560,1447517,3034077
"529","Colombia",2003,40,1462494,1335081,2797575
"530","Colombia",2003,45,1213819,1067767,2281586
"531","Colombia",2003,50,1024132,912700,1936832
"532","Colombia",2003,55,780611,696243,1476854
"533","Colombia",2003,60,597467,515460,1112927
"534","Colombia",2003,65,478153,405493,883646
"535","Colombia",2003,70,374437,306121,680558
"536","Colombia",2003,75,262372,205873,468245
"537","Colombia",2003,80,156506,114666,271172
"538","Colombia",2003,85,74073,50770,124843
"539","Colombia",2003,90,29182,18856,48038
"540","Colombia",2003,95,7834,4616,12450
"541","Costa Rica",2004,0,176242,184567,360809
"542","Costa Rica",2004,5,193427,202284,395711
"543","Costa Rica",2004,10,205164,214090,419254
"544","Costa Rica",2004,15,208941,217244,426185
"545","Costa Rica",2004,20,192627,198903,391530
"546","Costa Rica",2004,25,171511,174844,346355
"547","Costa Rica",2004,30,151937,150981,302918
"548","Costa Rica",2004,35,156310,154103,310413
"549","Costa Rica",2004,40,155475,153746,309221
"550","Costa Rica",2004,45,131586,129839,261425
"551","Costa Rica",2004,50,100835,98914,199749
"552","Costa Rica",2004,55,83691,82442,166133
"553","Costa Rica",2004,60,62772,60726,123498
"554","Costa Rica",2004,65,49529,46774,96303
"555","Costa Rica",2004,70,38107,33987,72094
"556","Costa Rica",2004,75,27808,23067,50875
"557","Costa Rica",2004,80,17182,13122,30304
"558","Costa Rica",2004,85,8896,6166,15062
"559","Costa Rica",2004,90,3783,2270,6053
"560","Costa Rica",2004,95,1095,517,1612
"561","Croatia",2005,0,100173,105962,206135
"562","Croatia",2005,5,117926,124204,242130
"563","Croatia",2005,10,117266,123179,240445
"564","Croatia",2005,15,138522,144686,283208
"565","Croatia",2005,20,147456,153293,300749
"566","Croatia",2005,25,144512,149480,293992
"567","Croatia",2005,30,147439,150294,297733
"568","Croatia",2005,35,145470,144641,290111
"569","Croatia",2005,40,163286,160631,323917
"570","Croatia",2005,45,167516,165906,333422
"571","Croatia",2005,50,163019,163295,326314
"572","Croatia",2005,55,144014,136147,280161
"573","Croatia",2005,60,111131,93513,204644
"574","Croatia",2005,65,139826,109515,249341
"575","Croatia",2005,70,130625,91803,222428
"576","Croatia",2005,75,99155,56789,155944
"577","Croatia",2005,80,62469,24168,86637
"578","Croatia",2005,85,18919,6980,25899
"579","Croatia",2005,90,8998,3086,12084
"580","Croatia",2005,95,2029,743,2772
"581","Cuba",2004,0,326814,345798,672612
"582","Cuba",2004,5,360937,380084,741021
"583","Cuba",2004,10,361738,386970,748708
"584","Cuba",2004,15,416721,437181,853902
"585","Cuba",2004,20,358683,369371,728054
"586","Cuba",2004,25,356546,367498,724044
"587","Cuba",2004,30,511701,524237,1035938
"588","Cuba",2004,35,540226,532318,1072544
"589","Cuba",2004,40,529774,519693,1049467
"590","Cuba",2004,45,342541,333521,676062
"591","Cuba",2004,50,341333,320656,661989
"592","Cuba",2004,55,289376,278160,567536
"593","Cuba",2004,60,257633,248123,505756
"594","Cuba",2004,65,207388,193388,400776
"595","Cuba",2004,70,156376,142729,299105
"596","Cuba",2004,75,124883,106942,231825
"597","Cuba",2004,80,86713,69415,156128
"598","Cuba",2004,85,49262,37285,86547
"599","Cuba",2004,90,22082,14907,36989
"600","Cuba",2004,95,7644,4939,12583
"601","Cyprus",2004,0,29733,31700,61433
"602","Cyprus",2004,5,33702,35706,69408
"603","Cyprus",2004,10,36269,38398,74667
"604","Cyprus",2004,15,38229,42852,81081
"605","Cyprus",2004,20,43629,52086,95715
"606","Cyprus",2004,25,40543,46038,86581
"607","Cyprus",2004,30,37590,39416,77006
"608","Cyprus",2004,35,35904,35955,71859
"609","Cyprus",2004,40,35776,36588,72364
"610","Cyprus",2004,45,34976,34383,69359
"611","Cyprus",2004,50,30396,30585,60981
"612","Cyprus",2004,55,27365,26360,53725
"613","Cyprus",2004,60,22045,20803,42848
"614","Cyprus",2004,65,19176,17466,36642
"615","Cyprus",2004,70,15434,13037,28471
"616","Cyprus",2004,75,12157,9207,21364
"617","Cyprus",2004,80,8006,6159,14165
"618","Cyprus",2004,85,4286,2766,7052
"619","Cyprus",2004,90,1655,845,2500
"620","Cyprus",2004,95,312,124,436
"21","Czechia",2009,0,58492.8,61500,119992.8
"22","Czechia",2009,5,206223.14,217349.38,423572.52
"23","Czechia",2009,10,222352.34,235413.11,457765.45
"24","Czechia",2009,15,230933.71,243597.38,474531.09
"25","Czechia",2009,20,310336.97,325618.09,635955.06
"26","Czechia",2009,25,336061.84,355241.58,691303.42
"27","Czechia",2009,30,372578.37,394411.32,766989.69
"28","Czechia",2009,35,453244.01,476631.02,929875.03
"29","Czechia",2009,40,382471.38,404747.38,787218.76
"30","Czechia",2009,45,342690.34,359959.75,702650.09
"31","Czechia",2009,50,320595.04,330710.78,651305.82
"32","Czechia",2009,55,366410.89,362931.2,729342.09
"33","Czechia",2009,60,392302.1,372929.68,765231.78
"34","Czechia",2009,65,373365.89,335231.08,708596.97
"35","Czechia",2009,70,277656,229778.96,507434.96
"36","Czechia",2009,75,210092.25,153168.17,363260.42
"37","Czechia",2009,80,199481.15,125244.13,324725.28
"38","Czechia",2009,85,149849.28,75214.69,225063.97
"39","Czechia",2009,90,78970.32,31207.23,110177.55
"40","Czechia",2009,95,19541.33,5805.01,25346.34
"41","Denmark",1993,0,32894,34757,67651
"42","Denmark",1993,5,121837,128236,250073
"43","Denmark",1993,10,133751,140336,274087
"44","Denmark",1993,15,142252,148500,290752
"45","Denmark",1993,20,170076,177825,347901
"46","Denmark",1993,25,182640,191684,374324
"47","Denmark",1993,30,205783,217918,423701
"48","Denmark",1993,35,184993,194267,379260
"49","Denmark",1993,40,182308,189972,372280
"50","Denmark",1993,45,184944,190261,375205
"51","Denmark",1993,50,201717,209165,410882
"52","Denmark",1993,55,153152,155670,308822
"53","Denmark",1993,60,132919,129104,262023
"54","Denmark",1993,65,124663,115655,240318
"55","Denmark",1993,70,124690,107752,232442
"56","Denmark",1993,75,116853,91841,208694
"57","Denmark",1993,80,96122,65816,161938
"58","Denmark",1993,85,74626,41816,116442
"59","Denmark",1993,90,41188,17716,58904
"60","Denmark",1993,95,18607,6361,24968
"621","Dominican Republic",2005,0,487788,507360,995148
"622","Dominican Republic",2005,5,492558,510998,1003556
"623","Dominican Republic",2005,10,492328,507075,999403
"624","Dominican Republic",2005,15,455918,468601,924519
"625","Dominican Republic",2005,20,412287,424569,836856
"626","Dominican Republic",2005,25,373044,376380,749424
"627","Dominican Republic",2005,30,336456,334938,671394
"628","Dominican Republic",2005,35,302986,296803,599789
"629","Dominican Republic",2005,40,267561,263241,530802
"630","Dominican Republic",2005,45,225311,223953,449264
"631","Dominican Republic",2005,50,179787,179537,359324
"632","Dominican Republic",2005,55,137435,137019,274454
"633","Dominican Republic",2005,60,107153,106416,213569
"634","Dominican Republic",2005,65,92062,90177,182239
"635","Dominican Republic",2005,70,69296,67091,136387
"636","Dominican Republic",2005,75,45347,42815,88162
"637","Dominican Republic",2005,80,25759,23278,49037
"638","Dominican Republic",2005,85,12090,10410,22500
"639","Dominican Republic",2005,90,4659,3718,8377
"640","Dominican Republic",2005,95,1770,1288,3058
"641","Ecuador",2008,0,762640,797572,1560212
"642","Ecuador",2008,5,758772,792052,1550824
"643","Ecuador",2008,10,757597,790408,1548005
"644","Ecuador",2008,15,718574,745614,1464188
"645","Ecuador",2008,20,676288,695800,1372088
"646","Ecuador",2008,25,618021,628959,1246980
"647","Ecuador",2008,30,560489,560578,1121067
"648","Ecuador",2008,35,510781,504824,1015605
"649","Ecuador",2008,40,451760,443982,895742
"650","Ecuador",2008,45,387011,377471,764482
"651","Ecuador",2008,50,329556,317546,647102
"652","Ecuador",2008,55,276884,263286,540170
"653","Ecuador",2008,60,198307,186322,384629
"654","Ecuador",2008,65,163321,150061,313382
"655","Ecuador",2008,70,123204,109254,232458
"656","Ecuador",2008,75,89387,75649,165036
"657","Ecuador",2008,80,57858,46577,104435
"658","Ecuador",2008,85,30985,23460,54445
"659","Ecuador",2008,90,13674,8707,22381
"660","Ecuador",2008,95,5652,2231,7883
"661","El Salvador",2004,0,319483,333740,653223
"662","El Salvador",2004,5,358970,374342,733312
"663","El Salvador",2004,10,353573,364474,718047
"664","El Salvador",2004,15,307354,302170,609524
"665","El Salvador",2004,20,271629,247092,518721
"666","El Salvador",2004,25,251804,215213,467017
"667","El Salvador",2004,30,226138,186307,412445
"668","El Salvador",2004,35,201212,163067,364279
"669","El Salvador",2004,40,177931,142883,320814
"670","El Salvador",2004,45,152297,121044,273341
"671","El Salvador",2004,50,134352,104370,238722
"672","El Salvador",2004,55,107352,85596,192948
"673","El Salvador",2004,60,91742,75670,167412
"674","El Salvador",2004,65,75567,65797,141364
"675","El Salvador",2004,70,57746,49432,107178
"676","El Salvador",2004,75,38812,31398,70210
"677","El Salvador",2004,80,23764,17486,41250
"678","El Salvador",2004,85,10347,6687,17034
"679","El Salvador",2004,90,2965,1572,4537
"680","El Salvador",2004,95,535,211,746
"681","Estonia",2004,0,32269,33943,66212
"682","Estonia",2004,5,29393,30972,60365
"683","Estonia",2004,10,38296,40599,78895
"684","Estonia",2004,15,49608,53111,102719
"685","Estonia",2004,20,48349,50810,99159
"686","Estonia",2004,25,46325,48701,95026
"687","Estonia",2004,30,48185,49388,97573
"688","Estonia",2004,35,45029,44257,89286
"689","Estonia",2004,40,49541,47464,97005
"690","Estonia",2004,45,51394,46706,98100
"691","Estonia",2004,50,49917,42753,92670
"692","Estonia",2004,55,45603,36285,81888
"693","Estonia",2004,60,40133,29479,69612
"694","Estonia",2004,65,45806,29303,75109
"695","Estonia",2004,70,38284,21444,59728
"696","Estonia",2004,75,33816,15075,48891
"697","Estonia",2004,80,21273,6439,27712
"698","Estonia",2004,85,7823,2198,10021
"699","Estonia",2004,90,3821,907,4728
"700","Estonia",2004,95,799,152,951
"701","Eswatini",1996,0,74789,75929,150718
"702","Eswatini",1996,5,70394,71330,141724
"703","Eswatini",1996,10,68109,68610,136719
"704","Eswatini",1996,15,56076,52418,108494
"705","Eswatini",1996,20,45664,37899,83563
"706","Eswatini",1996,25,35717,26875,62592
"707","Eswatini",1996,30,29417,20850,50267
"708","Eswatini",1996,35,24608,18882,43490
"709","Eswatini",1996,40,19982,17039,37021
"710","Eswatini",1996,45,15589,15057,30646
"711","Eswatini",1996,50,12221,11896,24117
"712","Eswatini",1996,55,10465,8693,19158
"713","Eswatini",1996,60,8099,6405,14504
"714","Eswatini",1996,65,5840,4578,10418
"715","Eswatini",1996,70,3877,3015,6892
"716","Eswatini",1996,75,2314,1750,4064
"717","Eswatini",1996,80,1083,764,1847
"718","Eswatini",1996,85,323,208,531
"719","Eswatini",1996,90,44,25,69
"720","Eswatini",1996,95,2,0,2
"721","Ethiopia",2004,0,6692893,6860220,13553113
"722","Ethiopia",2004,5,5944413,6084073,12028486
"723","Ethiopia",2004,10,4917255,4995093,9912348
"724","Ethiopia",2004,15,3983757,4028566,8012323
"725","Ethiopia",2004,20,3375521,3336312,6711833
"726","Ethiopia",2004,25,2713390,2667087,5380477
"727","Ethiopia",2004,30,2216010,2280157,4496167
"728","Ethiopia",2004,35,1837636,1757215,3594851
"729","Ethiopia",2004,40,1455616,1345847,2801463
"730","Ethiopia",2004,45,1277808,1148000,2425808
"731","Ethiopia",2004,50,1024616,965251,1989867
"732","Ethiopia",2004,55,901913,815857,1717770
"733","Ethiopia",2004,60,694621,650192,1344813
"734","Ethiopia",2004,65,503086,471947,975033
"735","Ethiopia",2004,70,369999,351028,721027
"736","Ethiopia",2004,75,208533,176278,384811
"737","Ethiopia",2004,80,109880,94516,204396
"738","Ethiopia",2004,85,35350,37944,73294
"739","Ethiopia",2004,90,8741,7865,16606
"740","Ethiopia",2004,95,1194,630,1824
"61","Finland",1997,0,29482,30966,60448
"62","Finland",1997,5,127354,132370,259724
"63","Finland",1997,10,157050,163925,320975
"64","Finland",1997,15,159922,167498,327420
"65","Finland",1997,20,159261,166083,325344
"66","Finland",1997,25,151543,159086,310629
"67","Finland",1997,30,164059,170510,334569
"68","Finland",1997,35,184737,192790,377527
"69","Finland",1997,40,186520,193667,380187
"70","Finland",1997,45,198430,204651,403081
"71","Finland",1997,50,210461,218371,428832
"72","Finland",1997,55,166161,168729,334890
"73","Finland",1997,60,145428,140106,285534
"74","Finland",1997,65,125929,114076,240005
"75","Finland",1997,70,130460,105880,236340
"76","Finland",1997,75,120441,78832,199273
"77","Finland",1997,80,93711,47688,141399
"78","Finland",1997,85,68108,28321,96429
"79","Finland",1997,90,38537,13351,51888
"80","Finland",1997,95,14258,3755,18013
"741","France",2005,0,1872482,1962100,3834582
"742","France",2005,5,1812100,1905736,3717836
"743","France",2005,10,1831999,1918990,3750989
"744","France",2005,15,1944862,2009156,3954018
"745","France",2005,20,1964008,1985178,3949186
"746","France",2005,25,1877121,1862134,3739255
"747","France",2005,30,2124714,2107041,4231755
"748","France",2005,35,2191853,2156882,4348735
"749","France",2005,40,2226091,2168610,4394701
"750","France",2005,45,2140757,2063690,4204447
"751","France",2005,50,2115256,2038126,4153382
"752","France",2005,55,2061369,1982736,4044105
"753","France",2005,60,1406118,1323371,2729489
"754","France",2005,65,1387756,1201830,2589586
"755","France",2005,70,1416694,1109372,2526066
"756","France",2005,75,1283408,881359,2164767
"757","France",2005,80,1056551,605501,1662052
"758","France",2005,85,436471,195943,632414
"759","France",2005,90,290997,93439,384436
"760","France",2005,95,89377,18950,108327
"761","Germany",2013,0,1701092,1791874,3492966
"762","Germany",2013,5,1704214,1804175,3508389
"763","Germany",2013,10,1845814,1962623,3808437
"764","Germany",2013,15,2036054,2173553,4209607
"765","Germany",2013,20,2153673,2301481,4455154
"766","Germany",2013,25,2476676,2624258,5100934
"767","Germany",2013,30,2540866,2627129,5167995
"768","Germany",2013,35,2420661,2456900,4877561
"769","Germany",2013,40,2511999,2561843,5073842
"770","Germany",2013,45,3297115,3374222,6671337
"771","Germany",2013,50,3419720,3487804,6907524
"772","Germany",2013,55,3011882,3015375,6027257
"773","Germany",2013,60,2624594,2507680,5132274
"774","Germany",2013,65,2184827,2052125,4236952
"775","Germany",2013,70,2254142,1982898,4237040
"776","Germany",2013,75,2364588,1851048,4215636
"777","Germany",2013,80,1499569,998346,2497915
"778","Germany",2013,85,978995,493850,1472845
"779","Germany",2013,90,448788,138122,586910
"780","Germany",2013,95,87566,19270,106836
"781","Greece",2016,0,229982,245467,475449
"782","Greece",2016,5,263917,280475,544392
"783","Greece",2016,10,260123,272076,532199
"784","Greece",2016,15,265487,276844,542331
"785","Greece",2016,20,259009,284985,543994
"786","Greece",2016,25,294441,317693,612134
"787","Greece",2016,30,366972,383305,750277
"788","Greece",2016,35,388044,402148,790192
"789","Greece",2016,40,400800,403550,804350
"790","Greece",2016,45,408021,401737,809758
"791","Greece",2016,50,372503,354327,726830
"792","Greece",2016,55,363774,336169,699943
"793","Greece",2016,60,320654,287770,608424
"794","Greece",2016,65,309456,277335,586791
"795","Greece",2016,70,241265,211124,452389
"796","Greece",2016,75,273198,211771,484969
"797","Greece",2016,80,228710,163950,392660
"798","Greece",2016,85,124715,88578,213293
"799","Greece",2016,90,44854,27566,72420
"800","Greece",2016,95,10956,5986,16942
"801","Haiti",2003,0,609204,630925,1240129
"802","Haiti",2003,5,574894,592626,1167520
"803","Haiti",2003,10,545407,556712,1102119
"804","Haiti",2003,15,517666,520200,1037866
"805","Haiti",2003,20,481512,471316,952828
"806","Haiti",2003,25,375182,353584,728766
"807","Haiti",2003,30,293339,266312,559651
"808","Haiti",2003,35,256754,235994,492748
"809","Haiti",2003,40,225049,206485,431534
"810","Haiti",2003,45,184427,174108,358535
"811","Haiti",2003,50,157619,146258,303877
"812","Haiti",2003,55,119510,105401,224911
"813","Haiti",2003,60,106821,95339,202160
"814","Haiti",2003,65,86794,73017,159811
"815","Haiti",2003,70,61535,50300,111835
"816","Haiti",2003,75,37439,29775,67214
"817","Haiti",2003,80,19730,15068,34798
"818","Haiti",2003,85,8325,5826,14151
"819","Haiti",2003,90,2453,1555,4008
"820","Haiti",2003,95,542,286,828
"821","Hungary",2004,0,231730,244386,476116
"822","Hungary",2004,5,240296,253381,493677
"823","Hungary",2004,10,290918,304304,595222
"824","Hungary",2004,15,308952,321912,630864
"825","Hungary",2004,20,329222,342675,671897
"826","Hungary",2004,25,419378,437395,856773
"827","Hungary",2004,30,374184,385895,760079
"828","Hungary",2004,35,340557,346924,687481
"829","Hungary",2004,40,303451,297474,600925
"830","Hungary",2004,45,376434,353014,729448
"831","Hungary",2004,50,415936,375939,791875
"832","Hungary",2004,55,342063,293671,635734
"833","Hungary",2004,60,324920,255632,580552
"834","Hungary",2004,65,281212,189504,470716
"835","Hungary",2004,70,262712,165073,427785
"836","Hungary",2004,75,218846,117214,336060
"837","Hungary",2004,80,162463,72802,235265
"838","Hungary",2004,85,46900,19134,66034
"839","Hungary",2004,90,25365,8595,33960
"840","Hungary",2004,95,4266,1213,5479
"841","Iceland",2005,0,10210,10599,20809
"842","Iceland",2005,5,10383,10864,21247
"843","Iceland",2005,10,11416,11955,23371
"844","Iceland",2005,15,10413,10847,21260
"845","Iceland",2005,20,10657,11138,21795
"846","Iceland",2005,25,10462,10532,20994
"847","Iceland",2005,30,10136,10627,20763
"848","Iceland",2005,35,10272,10435,20707
"849","Iceland",2005,40,10864,10892,21756
"850","Iceland",2005,45,10400,10641,21041
"851","Iceland",2005,50,9090,9530,18620
"852","Iceland",2005,55,7725,8188,15913
"853","Iceland",2005,60,6000,5865,11865
"854","Iceland",2005,65,4696,4529,9225
"855","Iceland",2005,70,4743,4297,9040
"856","Iceland",2005,75,4026,3358,7384
"857","Iceland",2005,80,3047,2241,5288
"858","Iceland",2005,85,1634,968,2602
"859","Iceland",2005,90,694,326,1020
"860","Iceland",2005,95,202,74,276
"861","India",2003,0,61151111,68391874,129542985
"862","India",2003,5,59066975,66315926,125382901
"863","India",2003,10,57010814,63782894,120793708
"864","India",2003,15,55186490,61074040,116260530
"865","India",2003,20,51305025,56563709,107868734
"866","India",2003,25,45301096,49379563,94680659
"867","India",2003,30,40477175,43813617,84290792
"868","India",2003,35,35872212,38782123,74654335
"869","India",2003,40,32018517,34629832,66648349
"870","India",2003,45,27994493,30233392,58227885
"871","India",2003,50,24078952,25782165,49861117
"872","India",2003,55,18106791,18296224,36403015
"873","India",2003,60,14464461,14157575,28622036
"874","India",2003,65,11695731,10846358,22542089
"875","India",2003,70,8164694,7394023,15558717
"876","India",2003,75,4890681,4462225,9352906
"877","India",2003,80,2464368,2167222,4631590
"878","India",2003,85,971201,772711,1743912
"879","India",2003,90,264514,172854,437368
"880","India",2003,95,72410,33886,106296
"881","Indonesia",2004,0,10872667,11385429,22258096
"882","Indonesia",2004,5,11142495,11578195,22720690
"883","Indonesia",2004,10,11091725,11547645,22639370
"884","Indonesia",2004,15,10901483,11232554,22134037
"885","Indonesia",2004,20,10444025,10543198,20987223
"886","Indonesia",2004,25,10212041,10304042,20516083
"887","Indonesia",2004,30,9329416,9452089,18781505
"888","Indonesia",2004,35,8318511,8491090,16809601
"889","Indonesia",2004,40,7170396,7308715,14479111
"890","Indonesia",2004,45,5768058,5837307,11605365
"891","Indonesia",2004,50,4634162,4582557,9216719
"892","Indonesia",2004,55,3734371,3692821,7427192
"893","Indonesia",2004,60,3051631,2799218,5850849
"894","Indonesia",2004,65,2403094,2115330,4518424
"895","Indonesia",2004,70,1765313,1424566,3189879
"896","Indonesia",2004,75,1041149,776584,1817733
"897","Indonesia",2004,80,576067,387169,963236
"898","Indonesia",2004,85,199910,110547,310457
"899","Indonesia",2004,90,36875,21257,58132
"900","Indonesia",2004,95,3692,2074,5766
"901","Iraq",1990,0,1450743,1533249,2983992
"902","Iraq",1990,5,1277138,1347606,2624744
"903","Iraq",1990,10,1151671,1216012,2367683
"904","Iraq",1990,15,994796,1038773,2033569
"905","Iraq",1990,20,827852,826091,1653943
"906","Iraq",1990,25,580526,545470,1125996
"907","Iraq",1990,30,444318,415257,859575
"908","Iraq",1990,35,445320,426481,871801
"909","Iraq",1990,40,271379,285544,556923
"910","Iraq",1990,45,262932,275730,538662
"911","Iraq",1990,50,226489,228165,454654
"912","Iraq",1990,55,190796,187987,378783
"913","Iraq",1990,60,154714,147233,301947
"914","Iraq",1990,65,127047,118125,245172
"915","Iraq",1990,70,104210,93439,197649
"916","Iraq",1990,75,69776,58878,128654
"917","Iraq",1990,80,37078,29425,66503
"918","Iraq",1990,85,13889,9682,23571
"919","Iraq",1990,90,2951,1793,4744
"920","Iraq",1990,95,350,198,548
"921","Ireland",2004,0,145089,153514,298603
"922","Ireland",2004,5,131033,137647,268680
"923","Ireland",2004,10,130981,138237,269218
"924","Ireland",2004,15,145090,152515,297605
"925","Ireland",2004,20,172963,177826,350789
"926","Ireland",2004,25,179551,181953,361504
"927","Ireland",2004,30,172696,175132,347828
"928","Ireland",2004,35,150878,153180,304058
"929","Ireland",2004,40,144816,146159,290975
"930","Ireland",2004,45,130804,130430,261234
"931","Ireland",2004,50,125721,126482,252203
"932","Ireland",2004,55,113909,115031,228940
"933","Ireland",2004,60,86843,87362,174205
"934","Ireland",2004,65,70986,68856,139842
"935","Ireland",2004,70,55299,51810,107109
"936","Ireland",2004,75,46188,34355,80543
"937","Ireland",2004,80,39124,23109,62233
"938","Ireland",2004,85,21594,10331,31925
"939","Ireland",2004,90,8530,2963,11493
"940","Ireland",2004,95,1808,423,2231
"941","Israel",2002,0,295159,311904,607063
"942","Israel",2002,5,263642,277535,541177
"943","Israel",2002,10,254521,266784,521305
"944","Israel",2002,15,253523,268550,522073
"945","Israel",2002,20,246284,262063,508347
"946","Israel",2002,25,226575,231359,457934
"947","Israel",2002,30,197338,189330,386668
"948","Israel",2002,35,188355,177313,365668
"949","Israel",2002,40,184238,170159,354397
"950","Israel",2002,45,190370,177423,367793
"951","Israel",2002,50,160754,152319,313073
"952","Israel",2002,55,110626,101380,212006
"953","Israel",2002,60,102913,89202,192115
"954","Israel",2002,65,99632,81886,181518
"955","Israel",2002,70,91617,66770,158387
"956","Israel",2002,75,72203,53594,125797
"957","Israel",2002,80,42709,29710,72419
"958","Israel",2002,85,25607,16151,41758
"959","Israel",2002,90,8268,5258,13526
"960","Israel",2002,95,1789,1136,2925
"961","Italy",1995,0,1322901,1403577,2726478
"962","Italy",1995,5,1365859,1445951,2811810
"963","Italy",1995,10,1478822,1559154,3037976
"964","Italy",1995,15,1750652,1827770,3578422
"965","Italy",1995,20,2123398,2191731,4315129
"966","Italy",1995,25,2270077,2321997,4592074
"967","Italy",1995,30,2261617,2288234,4549851
"968","Italy",1995,35,2034981,2026872,4061853
"969","Italy",1995,40,1936462,1911870,3848332
"970","Italy",1995,45,2001814,1969743,3971557
"971","Italy",1995,50,1718912,1666220,3385132
"972","Italy",1995,55,1830995,1738293,3569288
"973","Italy",1995,60,1706474,1550900,3257374
"974","Italy",1995,65,1641531,1376411,3017942
"975","Italy",1995,70,1521084,1111824,2632908
"976","Italy",1995,75,881329,579927,1461256
"977","Italy",1995,80,903176,504935,1408111
"978","Italy",1995,85,482579,215566,698145
"979","Italy",1995,90,156928,53016,209944
"980","Italy",1995,95,32433,8397,40830
"981","Jamaica",2004,0,125879,131596,257475
"982","Jamaica",2004,5,139622,146234,285856
"983","Jamaica",2004,10,137678,144489,282167
"984","Jamaica",2004,15,127544,136300,263844
"985","Jamaica",2004,20,116982,115569,232551
"986","Jamaica",2004,25,103967,100220,204187
"987","Jamaica",2004,30,100429,95240,195669
"988","Jamaica",2004,35,102259,92943,195202
"989","Jamaica",2004,40,92408,84951,177359
"990","Jamaica",2004,45,76301,66493,142794
"991","Jamaica",2004,50,60684,59875,120559
"992","Jamaica",2004,55,44431,45006,89437
"993","Jamaica",2004,60,38304,37419,75723
"994","Jamaica",2004,65,33187,30631,63818
"995","Jamaica",2004,70,29875,25580,55455
"996","Jamaica",2004,75,24188,21442,45630
"997","Jamaica",2004,80,16190,13704,29894
"998","Jamaica",2004,85,8579,6700,15279
"999","Jamaica",2004,90,3201,2469,5670
"1000","Jamaica",2004,95,750,681,1431
"81","Japan",2010,0,514785.56,541074.35,1055859.91
"82","Japan",2010,5,2073564.17,2176030.23,4249594.4
"83","Japan",2010,10,2749654.28,2888429.9,5638084.18
"84","Japan",2010,15,2886473.22,3030569.89,5917043.11
"85","Japan",2010,20,2928792.15,3091219.32,6020011.47
"86","Japan",2010,25,3159032.78,3314843.09,6473875.87
"87","Japan",2010,30,3564827.93,3702994.77,7267822.7
"88","Japan",2010,35,4146929.71,4295682.71,8442612.42
"89","Japan",2010,40,4755581.56,4915108.2,9670689.76
"90","Japan",2010,45,4224733.23,4325923.72,8550656.95
"91","Japan",2010,50,3876881.74,3936573.94,7813455.68
"92","Japan",2010,55,3837738.15,3841287.16,7679025.31
"93","Japan",2010,60,4548142.77,4475440.62,9023583.39
"94","Japan",2010,65,4894822.52,4711364.43,9606186.95
"95","Japan",2010,70,4354516.61,3989324.63,8343841.24
"96","Japan",2010,75,3724191.12,3199318.8,6923509.92
"97","Japan",2010,80,3316838.79,2535392.9,5852231.69
"98","Japan",2010,85,2594020.74,1643040.03,4237060.77
"99","Japan",2010,90,1635239.37,692629.15,2327868.52
"100","Japan",2010,95,983903.34,285266.75,1269170.09
"1001","Kenya",2004,0,3075279,3132962,6208241
"1002","Kenya",2004,5,2678639,2704826,5383465
"1003","Kenya",2004,10,2265564,2267560,4533124
"1004","Kenya",2004,15,2137713,2129771,4267484
"1005","Kenya",2004,20,1872119,1860051,3732170
"1006","Kenya",2004,25,1529647,1517647,3047294
"1007","Kenya",2004,30,1214321,1204382,2418703
"1008","Kenya",2004,35,935381,922335,1857716
"1009","Kenya",2004,40,731426,707257,1438683
"1010","Kenya",2004,45,577235,541072,1118307
"1011","Kenya",2004,50,454134,409032,863166
"1012","Kenya",2004,55,322364,280441,602805
"1013","Kenya",2004,60,214015,177604,391619
"1014","Kenya",2004,65,177500,137043,314543
"1015","Kenya",2004,70,136507,98857,235364
"1016","Kenya",2004,75,81033,53573,134606
"1017","Kenya",2004,80,36873,21536,58409
"1018","Kenya",2004,85,11279,5369,16648
"1019","Kenya",2004,90,1713,666,2379
"1020","Kenya",2004,95,129,42,171
"1021","Latvia",2007,0,49168,51546,100714
"1022","Latvia",2007,5,44534,47345,91879
"1023","Latvia",2007,10,67937,70058,137995
"1024","Latvia",2007,15,89083,93057,182140
"1025","Latvia",2007,20,83658,86881,170539
"1026","Latvia",2007,25,74991,76600,151591
"1027","Latvia",2007,30,78564,78460,157024
"1028","Latvia",2007,35,75790,73871,149661
"1029","Latvia",2007,40,86854,79916,166770
"1030","Latvia",2007,45,87082,77785,164867
"1031","Latvia",2007,50,79072,66233,145305
"1032","Latvia",2007,55,71809,55160,126969
"1033","Latvia",2007,60,74466,52441,126907
"1034","Latvia",2007,65,79253,49316,128569
"1035","Latvia",2007,70,64410,34835,99245
"1036","Latvia",2007,75,57544,24127,81671
"1037","Latvia",2007,80,35132,9899,45031
"1038","Latvia",2007,85,12339,3187,15526
"1039","Latvia",2007,90,6403,1478,7881
"1040","Latvia",2007,95,1408,304,1712
"1041","Lithuania",1999,0,88668,93960,182628
"1042","Lithuania",1999,5,118219,123936,242155
"1043","Lithuania",1999,10,135892,141076,276968
"1044","Lithuania",1999,15,127845,133181,261026
"1045","Lithuania",1999,20,115702,117632,233334
"1046","Lithuania",1999,25,124561,124214,248775
"1047","Lithuania",1999,30,126405,127018,253423
"1048","Lithuania",1999,35,142001,138385,280386
"1049","Lithuania",1999,40,133708,123961,257669
"1050","Lithuania",1999,45,113675,102323,215998
"1051","Lithuania",1999,50,103457,86408,189865
"1052","Lithuania",1999,55,104754,82495,187249
"1053","Lithuania",1999,60,107504,77803,185307
"1054","Lithuania",1999,65,101062,66068,167130
"1055","Lithuania",1999,70,92909,50104,143013
"1056","Lithuania",1999,75,67702,28921,96623
"1057","Lithuania",1999,80,29990,13222,43212
"1058","Lithuania",1999,85,19596,5352,24948
"1059","Lithuania",1999,90,7492,2449,9941
"1060","Lithuania",1999,95,1715,477,2192
"1061","Luxembourg",1995,0,13273,14055,27328
"1062","Luxembourg",1995,5,12211,12730,24941
"1063","Luxembourg",1995,10,11185,11782,22967
"1064","Luxembourg",1995,15,10892,11349,22241
"1065","Luxembourg",1995,20,12773,13114,25887
"1066","Luxembourg",1995,25,16263,16834,33097
"1067","Luxembourg",1995,30,17767,18309,36076
"1068","Luxembourg",1995,35,16674,17172,33846
"1069","Luxembourg",1995,40,14982,15791,30773
"1070","Luxembourg",1995,45,13325,14534,27859
"1071","Luxembourg",1995,50,11488,11965,23453
"1072","Luxembourg",1995,55,11140,11021,22161
"1073","Luxembourg",1995,60,10743,9999,20742
"1074","Luxembourg",1995,65,10614,9041,19655
"1075","Luxembourg",1995,70,9130,5421,14551
"1076","Luxembourg",1995,75,5905,3386,9291
"1077","Luxembourg",1995,80,5168,2528,7696
"1078","Luxembourg",1995,85,2963,1049,4012
"1079","Luxembourg",1995,90,1040,267,1307
"1080","Luxembourg",1995,95,222,40,262
"1081","Malawi",2004,0,1137530,1152574,2290104
"1082","Malawi",2004,5,959105,962810,1921915
"1083","Malawi",2004,10,827818,816189,1644007
"1084","Malawi",2004,15,718294,699181,1417475
"1085","Malawi",2004,20,564717,550760,1115477
"1086","Malawi",2004,25,468747,460096,928843
"1087","Malawi",2004,30,378228,371356,749584
"1088","Malawi",2004,35,302307,290011,592318
"1089","Malawi",2004,40,239581,225913,465494
"1090","Malawi",2004,45,193790,179682,373472
"1091","Malawi",2004,50,155428,142792,298220
"1092","Malawi",2004,55,140226,122127,262353
"1093","Malawi",2004,60,112562,92093,204655
"1094","Malawi",2004,65,85383,65492,150875
"1095","Malawi",2004,70,59649,43791,103440
"1096","Malawi",2004,75,38579,24977,63556
"1097","Malawi",2004,80,20449,10953,31402
"1098","Malawi",2004,85,7556,3310,10866
"1099","Malawi",2004,90,1300,450,1750
"1100","Malawi",2004,95,110,34,144
"1101","Malta",2009,0,9503,10027,19530
"1102","Malta",2009,5,9498,10014,19512
"1103","Malta",2009,10,11320,11739,23059
"1104","Malta",2009,15,13063,13873,26936
"1105","Malta",2009,20,14494,15006,29500
"1106","Malta",2009,25,14322,15560,29882
"1107","Malta",2009,30,14313,15355,29668
"1108","Malta",2009,35,13755,14219,27974
"1109","Malta",2009,40,12213,12710,24923
"1110","Malta",2009,45,13838,14061,27899
"1111","Malta",2009,50,15529,15441,30970
"1112","Malta",2009,55,14486,14634,29120
"1113","Malta",2009,60,15329,14955,30284
"1114","Malta",2009,65,11325,10366,21691
"1115","Malta",2009,70,8449,6874,15323
"1116","Malta",2009,75,8018,5608,13626
"1117","Malta",2009,80,5102,3045,8147
"1118","Malta",2009,85,2843,1584,4427
"1119","Malta",2009,90,969,450,1419
"1120","Malta",2009,95,280,87,367
"1121","Mexico",2004,0,5577350,5788875,11366225
"1122","Mexico",2004,5,5530050,5695404,11225454
"1123","Mexico",2004,10,5511131,5646289,11157420
"1124","Mexico",2004,15,5232344,5092115,10324459
"1125","Mexico",2004,20,4906368,4675117,9581485
"1126","Mexico",2004,25,4601912,4251370,8853282
"1127","Mexico",2004,30,4352124,4017208,8369332
"1128","Mexico",2004,35,3842963,3499053,7342016
"1129","Mexico",2004,40,3286957,3055130,6342087
"1130","Mexico",2004,45,2747381,2533549,5280930
"1131","Mexico",2004,50,2244909,2078394,4323303
"1132","Mexico",2004,55,1686827,1571326,3258153
"1133","Mexico",2004,60,1354659,1263632,2618291
"1134","Mexico",2004,65,1050240,935884,1986124
"1135","Mexico",2004,70,853875,706778,1560653
"1136","Mexico",2004,75,640758,496235,1136993
"1137","Mexico",2004,80,408391,304232,712623
"1138","Mexico",2004,85,211259,143601,354860
"1139","Mexico",2004,90,98124,63657,161781
"1140","Mexico",2004,95,30730,18998,49728
"1141","Moldova",2003,0,98995,106487,205482
"1142","Moldova",2003,5,117953,122530,240483
"1143","Moldova",2003,10,158463,165711,324174
"1144","Moldova",2003,15,205100,211669,416769
"1145","Moldova",2003,20,197774,200856,398630
"1146","Moldova",2003,25,173969,180601,354570
"1147","Moldova",2003,30,147958,144261,292219
"1148","Moldova",2003,35,127176,120813,247989
"1149","Moldova",2003,40,161415,145586,307001
"1150","Moldova",2003,45,171300,152722,324022
"1151","Moldova",2003,50,161198,139488,300686
"1152","Moldova",2003,55,100565,82518,183083
"1153","Moldova",2003,60,86915,64444,151359
"1154","Moldova",2003,65,89218,60812,150030
"1155","Moldova",2003,70,69231,42963,112194
"1156","Moldova",2003,75,56101,30752,86853
"1157","Moldova",2003,80,31272,15140,46412
"1158","Moldova",2003,85,8266,3271,11537
"1159","Moldova",2003,90,3664,1170,4834
"1160","Moldova",2003,95,771,198,969
"1161","Nepal",2005,0,1615065,1721298,3336363
"1162","Nepal",2005,5,1712790,1826516,3539306
"1163","Nepal",2005,10,1599232,1634352,3233584
"1164","Nepal",2005,15,1374646,1307358,2682004
"1165","Nepal",2005,20,1170919,1012562,2183481
"1166","Nepal",2005,25,1053355,905284,1958639
"1167","Nepal",2005,30,882788,854214,1737002
"1168","Nepal",2005,35,729254,759543,1488797
"1169","Nepal",2005,40,617544,633552,1251096
"1170","Nepal",2005,45,502182,511607,1013789
"1171","Nepal",2005,50,452095,462450,914545
"1172","Nepal",2005,55,345126,343686,688812
"1173","Nepal",2005,60,305167,303756,608923
"1174","Nepal",2005,65,239333,229626,468959
"1175","Nepal",2005,70,166889,142694,309583
"1176","Nepal",2005,75,112522,88784,201306
"1177","Nepal",2005,80,55101,37952,93053
"1178","Nepal",2005,85,18132,10528,28660
"1179","Nepal",2005,90,3919,1969,5888
"1180","Nepal",2005,95,505,205,710
"101","Netherlands",2000,0,98199,103549,201748
"102","Netherlands",2000,5,381722,400021,781743
"103","Netherlands",2000,10,489200,512470,1001670
"104","Netherlands",2000,15,470039,490343,960382
"105","Netherlands",2000,20,452554,474911,927465
"106","Netherlands",2000,25,472644,483242,955886
"107","Netherlands",2000,30,581496,594775,1176271
"108","Netherlands",2000,35,642876,671528,1314404
"109","Netherlands",2000,40,645269,669674,1314943
"110","Netherlands",2000,45,599941,614400,1214341
"111","Netherlands",2000,50,559041,575390,1134431
"112","Netherlands",2000,55,562629,582697,1145326
"113","Netherlands",2000,60,423754,435692,859446
"114","Netherlands",2000,65,365334,358118,723452
"115","Netherlands",2000,70,339326,305154,644480
"116","Netherlands",2000,75,307985,242386,550371
"117","Netherlands",2000,80,276639,180613,457252
"118","Netherlands",2000,85,181173.44,92979.38,274152.82
"119","Netherlands",2000,90,112568.06,43406.13,155974.19
"120","Netherlands",2000,95,53712.99,14477.82,68190.81
"1181","New Zealand",2004,0,139069,145506,284575
"1182","New Zealand",2004,5,142516,149820,292336
"1183","New Zealand",2004,10,152770,161276,314046
"1184","New Zealand",2004,15,150432,155067,305499
"1185","New Zealand",2004,20,142996,144715,287711
"1186","New Zealand",2004,25,131329,124766,256095
"1187","New Zealand",2004,30,154555,139660,294215
"1188","New Zealand",2004,35,161310,147675,308985
"1189","New Zealand",2004,40,163905,153577,317482
"1190","New Zealand",2004,45,154444,148687,303131
"1191","New Zealand",2004,50,127175,124984,252159
"1192","New Zealand",2004,55,120944,118004,238948
"1193","New Zealand",2004,60,91700,89618,181318
"1194","New Zealand",2004,65,75838,71488,147326
"1195","New Zealand",2004,70,62868,57814,120682
"1196","New Zealand",2004,75,55588,47128,102716
"1197","New Zealand",2004,80,43213,28964,72177
"1198","New Zealand",2004,85,25327,12514,37841
"1199","New Zealand",2004,90,10835,3838,14673
"1200","New Zealand",2004,95,2791,647,3438
"1201","Nicaragua",2004,0,321559,335118,656677
"1202","Nicaragua",2004,5,318844,335188,654032
"1203","Nicaragua",2004,10,321954,337388,659342
"1204","Nicaragua",2004,15,306052,318906,624958
"1205","Nicaragua",2004,20,283610,287214,570824
"1206","Nicaragua",2004,25,240481,231591,472072
"1207","Nicaragua",2004,30,199723,182499,382222
"1208","Nicaragua",2004,35,162891,144180,307071
"1209","Nicaragua",2004,40,139820,123886,263706
"1210","Nicaragua",2004,45,121961,108193,230154
"1211","Nicaragua",2004,50,97739,83003,180742
"1212","Nicaragua",2004,55,59283,50377,109660
"1213","Nicaragua",2004,60,53972,46767,100739
"1214","Nicaragua",2004,65,43162,38034,81196
"1215","Nicaragua",2004,70,33444,28154,61598
"1216","Nicaragua",2004,75,24944,18201,43145
"1217","Nicaragua",2004,80,15259,9968,25227
"1218","Nicaragua",2004,85,6792,4015,10807
"1219","Nicaragua",2004,90,2386,1183,3569
"1220","Nicaragua",2004,95,677,274,951
"1221","Nigeria",1990,0,8240137,8558758,16798895
"1222","Nigeria",1990,5,6906330,7150338,14056668
"1223","Nigeria",1990,10,5891018,6074195,11965213
"1224","Nigeria",1990,15,4873524,4997703,9871227
"1225","Nigeria",1990,20,3969550,4023205,7992755
"1226","Nigeria",1990,25,3342694,3375597,6718291
"1227","Nigeria",1990,30,2815442,2831798,5647240
"1228","Nigeria",1990,35,2366759,2351088,4717847
"1229","Nigeria",1990,40,2042836,2078394,4121230
"1230","Nigeria",1990,45,1761067,1770723,3531790
"1231","Nigeria",1990,50,1468151,1433385,2901536
"1232","Nigeria",1990,55,1195137,1132725,2327862
"1233","Nigeria",1990,60,950143,868442,1818585
"1234","Nigeria",1990,65,702807,615068,1317875
"1235","Nigeria",1990,70,452429,377197,829626
"1236","Nigeria",1990,75,230482,180780,411262
"1237","Nigeria",1990,80,85077,62761,147838
"1238","Nigeria",1990,85,19310,13144,32454
"1239","Nigeria",1990,90,2498,1497,3995
"1240","Nigeria",1990,95,176,89,265
"121","Norway",1990,0,28733,30325,59058
"122","Norway",1990,5,105547,110848,216395
"123","Norway",1990,10,125420,132079,257499
"124","Norway",1990,15,130823,137137,267960
"125","Norway",1990,20,156080,162977,319057
"126","Norway",1990,25,164764,173765,338529
"127","Norway",1990,30,156073,165177,321250
"128","Norway",1990,35,154894,162895,317789
"129","Norway",1990,40,148529,157198,305727
"130","Norway",1990,45,152821,162590,315411
"131","Norway",1990,50,118259,123450,241709
"132","Norway",1990,55,97176,97151,194327
"133","Norway",1990,60,95167,93466,188633
"134","Norway",1990,65,102453,96430,198883
"135","Norway",1990,70,115297,100230,215527
"136","Norway",1990,75,100525,78049,178574
"137","Norway",1990,80,83388,57121,140509
"138","Norway",1990,85,58457,32520,90977
"139","Norway",1990,90,31822,14502,46324
"140","Norway",1990,95,13517,5336,18853
"1241","Pakistan",2004,0,10897203,11842242,22739445
"1242","Pakistan",2004,5,10330304,11083939,21414243
"1243","Pakistan",2004,10,9681551,10243087,19924638
"1244","Pakistan",2004,15,8555286,9043186,17598472
"1245","Pakistan",2004,20,7145520,7547301,14692821
"1246","Pakistan",2004,25,5949283,6278411,12227694
"1247","Pakistan",2004,30,4977207,5247581,10224788
"1248","Pakistan",2004,35,4332718,4549669,8882387
"1249","Pakistan",2004,40,3745268,3922724,7667992
"1250","Pakistan",2004,45,3030895,3177643,6208538
"1251","Pakistan",2004,50,2285648,2387495,4673143
"1252","Pakistan",2004,55,1936701,2081602,4018303
"1253","Pakistan",2004,60,1657405,1799479,3456884
"1254","Pakistan",2004,65,1244882,1381541,2626423
"1255","Pakistan",2004,70,888444,981358,1869802
"1256","Pakistan",2004,75,554711,623263,1177974
"1257","Pakistan",2004,80,282085,327401,609486
"1258","Pakistan",2004,85,103633,124858,228491
"1259","Pakistan",2004,90,25021,29457,54478
"1260","Pakistan",2004,95,4014,3991,8005
"1261","Panama",2005,0,172657,179918,352575
"1262","Panama",2005,5,167197,173520,340717
"1263","Panama",2005,10,157088,162999,320087
"1264","Panama",2005,15,151492,157353,308845
"1265","Panama",2005,20,144166,149839,294005
"1266","Panama",2005,25,139375,142857,282232
"1267","Panama",2005,30,132366,134266,266632
"1268","Panama",2005,35,119204,119817,239021
"1269","Panama",2005,40,104422,104154,208576
"1270","Panama",2005,45,87468,86472,173940
"1271","Panama",2005,50,70757,69204,139961
"1272","Panama",2005,55,56571,55058,111629
"1273","Panama",2005,60,45542,43967,89509
"1274","Panama",2005,65,35921,34124,70045
"1275","Panama",2005,70,27112,25237,52349
"1276","Panama",2005,75,19335,17465,36800
"1277","Panama",2005,80,12665,10916,23581
"1278","Panama",2005,85,7009,5809,12818
"1279","Panama",2005,90,2933,2329,5262
"1280","Panama",2005,95,912,726,1638
"1281","Peru",2004,0,1441025,1496199,2937224
"1282","Peru",2004,5,1444891,1504601,2949492
"1283","Peru",2004,10,1491065,1552041,3043106
"1284","Peru",2004,15,1407409,1466711,2874120
"1285","Peru",2004,20,1287927,1321552,2609479
"1286","Peru",2004,25,1167689,1183290,2350979
"1287","Peru",2004,30,1066530,1055830,2122360
"1288","Peru",2004,35,953497,913573,1867070
"1289","Peru",2004,40,826017,789461,1615478
"1290","Peru",2004,45,686402,650616,1337018
"1291","Peru",2004,50,573147,532891,1106038
"1292","Peru",2004,55,435775,403843,839618
"1293","Peru",2004,60,358879,326254,685133
"1294","Peru",2004,65,293484,263459,556943
"1295","Peru",2004,70,228798,199439,428237
"1296","Peru",2004,75,162407,133985,296392
"1297","Peru",2004,80,94999,66852,161851
"1298","Peru",2004,85,39924,24999,64923
"1299","Peru",2004,90,11492,6267,17759
"1300","Peru",2004,95,1986,934,2920
"1301","Philippines",2008,0,5377391,5641774,11019165
"1302","Philippines",2008,5,5113090,5471090,10584180
"1303","Philippines",2008,10,5020108,5317155,10337263
"1304","Philippines",2008,15,4808505,4981152,9789657
"1305","Philippines",2008,20,4208177,4340896,8549073
"1306","Philippines",2008,25,3723929,3809735,7533664
"1307","Philippines",2008,30,3364245,3468150,6832395
"1308","Philippines",2008,35,2990691,3073270,6063961
"1309","Philippines",2008,40,2712709,2774691,5487400
"1310","Philippines",2008,45,2334165,2369593,4703758
"1311","Philippines",2008,50,1961076,1957274,3918350
"1312","Philippines",2008,55,1542272,1496413,3038685
"1313","Philippines",2008,60,1163884,1057906,2221790
"1314","Philippines",2008,65,826544,687405,1513949
"1315","Philippines",2008,70,653249,489901,1143150
"1316","Philippines",2008,75,425727,288154,713881
"1317","Philippines",2008,80,219648,121141,340789
"1318","Philippines",2008,85,92100,40340,132440
"1319","Philippines",2008,90,26454,9932,36386
"1320","Philippines",2008,95,5114,1734,6848
"1321","Poland",2009,0,977242,1030410,2007652
"1322","Poland",2009,5,873005,920383,1793388
"1323","Poland",2009,10,989462,1042250,2031712
"1324","Poland",2009,15,1223366,1288834,2512200
"1325","Poland",2009,20,1396383,1467196,2863579
"1326","Poland",2009,25,1593825,1658697,3252522
"1327","Poland",2009,30,1513577,1548852,3062429
"1328","Poland",2009,35,1333912,1350623,2684535
"1329","Poland",2009,40,1177142,1184855,2361997
"1330","Poland",2009,45,1258119,1244781,2502900
"1331","Poland",2009,50,1540341,1477820,3018161
"1332","Poland",2009,55,1478578,1342393,2820971
"1333","Poland",2009,60,1218850,1034857,2253707
"1334","Poland",2009,65,783241,597908,1381149
"1335","Poland",2009,70,821327,548381,1369708
"1336","Poland",2009,75,729651,418069,1147720
"1337","Poland",2009,80,532660,249025,781685
"1338","Poland",2009,85,272523,101539,374062
"1339","Poland",2009,90,64436,19958,84394
"1340","Poland",2009,95,19951,5362,25313
"141","Portugal",1999,0,54041,57555,111596
"142","Portugal",1999,5,208197,223077,431274
"143","Portugal",1999,10,273268,286981,560249
"144","Portugal",1999,15,291234,305322,596556
"145","Portugal",1999,20,353010,365048,718058
"146","Portugal",1999,25,402520,411372,813892
"147","Portugal",1999,30,387577,390620,778197
"148","Portugal",1999,35,380566,372052,752618
"149","Portugal",1999,40,377239,363379,740618
"150","Portugal",1999,45,356165,339856,696021
"151","Portugal",1999,50,341059,322368,663427
"152","Portugal",1999,55,321920,291114,613034
"153","Portugal",1999,60,286563,254944,541507
"154","Portugal",1999,65,298592,257757,556349
"155","Portugal",1999,70,284832,234985,519817
"156","Portugal",1999,75,249759,189924,439683
"157","Portugal",1999,80,189563,131999,321562
"158","Portugal",1999,85,126462.6,73646.71,200109.31
"159","Portugal",1999,90,74867.29,35303.62,110170.91
"160","Portugal",1999,95,29700.49,10243.13,39943.62
"1341","Romania",2004,0,508492,535841,1044333
"1342","Romania",2004,5,532309,560630,1092939
"1343","Romania",2004,10,601119,632351,1233470
"1344","Romania",2004,15,847737,890596,1738333
"1345","Romania",2004,20,764604,802019,1566623
"1346","Romania",2004,25,836295,873396,1709691
"1347","Romania",2004,30,796002,832737,1628739
"1348","Romania",2004,35,825280,853977,1679257
"1349","Romania",2004,40,585370,594634,1180004
"1350","Romania",2004,45,768227,753939,1522166
"1351","Romania",2004,50,799915,755970,1555885
"1352","Romania",2004,55,662244,594757,1257001
"1353","Romania",2004,60,514734,432409,947143
"1354","Romania",2004,65,635949,467194,1103143
"1355","Romania",2004,70,533277,388012,921289
"1356","Romania",2004,75,413998,276314,690312
"1357","Romania",2004,80,245964,139341,385305
"1358","Romania",2004,85,71657,35226,106883
"1359","Romania",2004,90,30701,16093,46794
"1360","Romania",2004,95,4837,3140,7977
"1361","Sierra Leone",2001,0,397128,391522,788650
"1362","Sierra Leone",2001,5,332735,329807,662542
"1363","Sierra Leone",2001,10,285830,287948,573778
"1364","Sierra Leone",2001,15,244552,249779,494331
"1365","Sierra Leone",2001,20,201301,206941,408242
"1366","Sierra Leone",2001,25,167078,169902,336980
"1367","Sierra Leone",2001,30,137611,138425,276036
"1368","Sierra Leone",2001,35,113594,112215,225809
"1369","Sierra Leone",2001,40,93265,89538,182803
"1370","Sierra Leone",2001,45,78848,72971,151819
"1371","Sierra Leone",2001,50,68774,63748,132522
"1372","Sierra Leone",2001,55,58823,53148,111971
"1373","Sierra Leone",2001,60,47024,41125,88149
"1374","Sierra Leone",2001,65,35591,29860,65451
"1375","Sierra Leone",2001,70,24452,19465,43917
"1376","Sierra Leone",2001,75,14401,10802,25203
"1377","Sierra Leone",2001,80,6783,4724,11507
"1378","Sierra Leone",2001,85,2354,1499,3853
"1379","Sierra Leone",2001,90,553,321,874
"1380","Sierra Leone",2001,95,89,44,133
"1381","Slovakia",2006,0,126460,132618,259078
"1382","Slovakia",2006,5,139709,146772,286481
"1383","Slovakia",2006,10,177037,185641,362678
"1384","Slovakia",2006,15,202761,211222,413983
"1385","Slovakia",2006,20,220082,229210,449292
"1386","Slovakia",2006,25,234188,242673,476861
"1387","Slovakia",2006,30,208375,213832,422207
"1388","Slovakia",2006,35,178800,180982,359782
"1389","Slovakia",2006,40,192275,192692,384967
"1390","Slovakia",2006,45,205280,201317,406597
"1391","Slovakia",2006,50,204609,194015,398624
"1392","Slovakia",2006,55,162751,145746,308497
"1393","Slovakia",2006,60,134502,107096,241598
"1394","Slovakia",2006,65,112901,79612,192513
"1395","Slovakia",2006,70,106138,67495,173633
"1396","Slovakia",2006,75,85901,46247,132148
"1397","Slovakia",2006,80,61913,28892,90805
"1398","Slovakia",2006,85,17607,7655,25262
"1399","Slovakia",2006,90,8702,3289,11991
"1400","Slovakia",2006,95,1494,471,1965
"1401","Slovenia",1992,0,59830,63023,122853
"1402","Slovenia",1992,5,68838,72194,141032
"1403","Slovenia",1992,10,73153,78846,151999
"1404","Slovenia",1992,15,69930,74606,144536
"1405","Slovenia",1992,20,75927,75250,151177
"1406","Slovenia",1992,25,78320,78124,156444
"1407","Slovenia",1992,30,79997,82816,162813
"1408","Slovenia",1992,35,81539,86718,168257
"1409","Slovenia",1992,40,65471,69363,134834
"1410","Slovenia",1992,45,60865,62955,123820
"1411","Slovenia",1992,50,58449,58773,117222
"1412","Slovenia",1992,55,61560,55268,116828
"1413","Slovenia",1992,60,57940,43160,101100
"1414","Slovenia",1992,65,51591,29733,81324
"1415","Slovenia",1992,70,23831,13625,37456
"1416","Slovenia",1992,75,32713,17738,50451
"1417","Slovenia",1992,80,20350,9278,29628
"1418","Slovenia",1992,85,8075,2904,10979
"1419","Slovenia",1992,90,2547,766,3313
"1420","Slovenia",1992,95,268,70,338
"1421","South Africa",2006,0,2439542,2497021,4936563
"1422","South Africa",2006,5,2376141,2416712,4792853
"1423","South Africa",2006,10,2508029,2548685,5056714
"1424","South Africa",2006,15,2650559,2695522,5346081
"1425","South Africa",2006,20,2478972,2519093,4998065
"1426","South Africa",2006,25,2127230,2145183,4272413
"1427","South Africa",2006,30,1893489,1874482,3767971
"1428","South Africa",2006,35,1603415,1565994,3169409
"1429","South Africa",2006,40,1365125,1303953,2669078
"1430","South Africa",2006,45,1168999,1077266,2246265
"1431","South Africa",2006,50,985506,875005,1860511
"1432","South Africa",2006,55,751955,644829,1396784
"1433","South Africa",2006,60,635737,523977,1159714
"1434","South Africa",2006,65,507872,393340,901212
"1435","South Africa",2006,70,373603,279328,652931
"1436","South Africa",2006,75,241185,160230,401415
"1437","South Africa",2006,80,120465,67518,187983
"1438","South Africa",2006,85,39411,17305,56716
"1439","South Africa",2006,90,5547,1916,7463
"1440","South Africa",2006,95,354,100,454
"1441","South Korea",1999,0,1511076,1660531,3171607
"1442","South Korea",1999,5,1631471,1855270,3486741
"1443","South Korea",1999,10,1455273,1653442,3108715
"1444","South Korea",1999,15,1859020,1981142,3840162
"1445","South Korea",1999,20,1930692,2035020,3965712
"1446","South Korea",1999,25,2175666,2299981,4475647
"1447","South Korea",1999,30,2153378,2242325,4395703
"1448","South Korea",1999,35,2105272,2165720,4270992
"1449","South Korea",1999,40,2006322,2053440,4059762
"1450","South Korea",1999,45,1475451,1484159,2959610
"1451","South Korea",1999,50,1200734,1246931,2447665
"1452","South Korea",1999,55,1026975,972021,1998996
"1453","South Korea",1999,60,940298,852866,1793164
"1454","South Korea",1999,65,794351,564948,1359299
"1455","South Korea",1999,70,564129,340077,904206
"1456","South Korea",1999,75,411158,221018,632176
"1457","South Korea",1999,80,218499,99422,317921
"1458","South Korea",1999,85,105735,34279,140014
"1459","South Korea",1999,90,34585,8321,42906
"1460","South Korea",1999,95,7241,998,8239
"161","Spain",2005,0,220123,235081,455204
"162","Spain",2005,5,840853,887789,1728642
"163","Spain",2005,10,963463,1016029,1979492
"164","Spain",2005,15,1019628,1078737,2098365
"165","Spain",2005,20,1133436,1197781,2331217
"166","Spain",2005,25,1455778,1530883,2986661
"167","Spain",2005,30,1819545,1940189,3759734
"168","Spain",2005,35,1813498,1933425,3746923
"169","Spain",2005,40,1755064,1826068,3581132
"170","Spain",2005,45,1666123,1692347,3358470
"171","Spain",2005,50,1492256,1489063,2981319
"172","Spain",2005,55,1286202,1266570,2552772
"173","Spain",2005,60,1251697,1198137,2449834
"174","Spain",2005,65,1094069,1022620,2116689
"175","Spain",2005,70,984202,861065,1845267
"176","Spain",2005,75,1072866,880021,1952887
"177","Spain",2005,80,899162,651199,1550361
"178","Spain",2005,85,671964.8,405321.74,1077286.54
"179","Spain",2005,90,355463.38,160665.6,516128.98
"180","Spain",2005,95,197079.21,69723.66,266802.87
"1461","Suriname",2006,0,25696,27585,53281
"1462","Suriname",2006,5,25310,27091,52401
"1463","Suriname",2006,10,24813,25927,50740
"1464","Suriname",2006,15,22490,24032,46522
"1465","Suriname",2006,20,21271,21624,42895
"1466","Suriname",2006,25,18616,19235,37851
"1467","Suriname",2006,30,19955,20392,40347
"1468","Suriname",2006,35,17323,18467,35790
"1469","Suriname",2006,40,17590,18051,35641
"1470","Suriname",2006,45,12438,12936,25374
"1471","Suriname",2006,50,10097,9465,19562
"1472","Suriname",2006,55,8635,7901,16536
"1473","Suriname",2006,60,7142,5853,12995
"1474","Suriname",2006,65,6155,5130,11285
"1475","Suriname",2006,70,4366,3879,8245
"1476","Suriname",2006,75,2990,2531,5521
"1477","Suriname",2006,80,1576,1254,2830
"1478","Suriname",2006,85,731,403,1134
"1479","Suriname",2006,90,260,133,393
"1480","Suriname",2006,95,86,32,118
"181","Sweden",1990,0,56317,59530,115847
"182","Sweden",1990,5,206302,217618,423920
"183","Sweden",1990,10,235279,247921,483200
"184","Sweden",1990,15,243300,255579,498879
"185","Sweden",1990,20,276583,289888,566471
"186","Sweden",1990,25,297937,314571,612508
"187","Sweden",1990,30,287767,304284,592051
"188","Sweden",1990,35,281764,296079,577843
"189","Sweden",1990,40,288806,301270,590076
"190","Sweden",1990,45,327770,340063,667833
"191","Sweden",1990,50,280393,294955,575348
"192","Sweden",1990,55,225956,229891,455847
"193","Sweden",1990,60,213226,206251,419477
"194","Sweden",1990,65,222788,207328,430116
"195","Sweden",1990,70,243695,216371,460066
"196","Sweden",1990,75,207294,170521,377815
"197","Sweden",1990,80,185616,135186,320802
"198","Sweden",1990,85,134314.12,80694.59,215008.71
"199","Sweden",1990,90,70899.15,33559,104458.15
"200","Sweden",1990,95,28865,10476,39341
"201","Switzerland",1991,0,40760,42511,83271
"202","Switzerland",1991,5,152985,160386,313371
"203","Switzerland",1991,10,187628,196331,383959
"204","Switzerland",1991,15,184654,193200,377854
"205","Switzerland",1991,20,205056,216195,421251
"206","Switzerland",1991,25,251256,254760,506016
"207","Switzerland",1991,30,278037,284233,562270
"208","Switzerland",1991,35,262801,272599,535400
"209","Switzerland",1991,40,248302,255051,503353
"210","Switzerland",1991,45,253197,260053,513250
"211","Switzerland",1991,50,235307,241828,477135
"212","Switzerland",1991,55,198584,197148,395732
"213","Switzerland",1991,60,186498,178848,365346
"214","Switzerland",1991,65,175519,153614,329133
"215","Switzerland",1991,70,165196,132531,297727
"216","Switzerland",1991,75,131650,99833,231483
"217","Switzerland",1991,80,123989,79926,203915
"218","Switzerland",1991,85,96249.09,50756,147005.09
"219","Switzerland",1991,90,52707,21999,74706
"220","Switzerland",1991,95,21427,6545,27972
"1481","Taiwan",1991,0,770779,833724,1604503
"1482","Taiwan",1991,5,922323,993319,1915642
"1483","Taiwan",1991,10,993718,1051749,2045467
"1484","Taiwan",1991,15,873436,914396,1787832
"1485","Taiwan",1991,20,921692,965654,1887346
"1486","Taiwan",1991,25,983369,1008643,1992012
"1487","Taiwan",1991,30,909395,947611,1857006
"1488","Taiwan",1991,35,815064,828398,1643462
"1489","Taiwan",1991,40,560226,620196,1180422
"1490","Taiwan",1991,45,444091,430740,874831
"1491","Taiwan",1991,50,419892,412070,831962
"1492","Taiwan",1991,55,357141,428974,786115
"1493","Taiwan",1991,60,313187,393214,706401
"1494","Taiwan",1991,65,255327,315350,570677
"1495","Taiwan",1991,70,182441,189856,372297
"1496","Taiwan",1991,75,127402,121963,249365
"1497","Taiwan",1991,80,62600,56528,119128
"1498","Taiwan",1991,85,24824,17326,42150
"1499","Taiwan",1991,90,6385,3512,9897
"1500","Taiwan",1991,95,1318,683,2001
"1501","Togo",2004,0,472571,473469,946040
"1502","Togo",2004,5,391408,391271,782679
"1503","Togo",2004,10,335811,335960,671771
"1504","Togo",2004,15,306810,306199,613009
"1505","Togo",2004,20,272169,270048,542217
"1506","Togo",2004,25,229871,225384,455255
"1507","Togo",2004,30,186011,180887,366898
"1508","Togo",2004,35,147321,142285,289606
"1509","Togo",2004,40,118186,112758,230944
"1510","Togo",2004,45,95867,90372,186239
"1511","Togo",2004,50,78782,73263,152045
"1512","Togo",2004,55,64440,58747,123187
"1513","Togo",2004,60,50738,45537,96275
"1514","Togo",2004,65,37745,32401,70146
"1515","Togo",2004,70,25212,20991,46203
"1516","Togo",2004,75,14151,11321,25472
"1517","Togo",2004,80,5942,4501,10443
"1518","Togo",2004,85,1630,1146,2776
"1519","Togo",2004,90,257,150,407
"1520","Togo",2004,95,22,9,31
"1521","Turkey",2004,0,3198141,3330978,6529119
"1522","Turkey",2004,5,3231898,3353022,6584920
"1523","Turkey",2004,10,3106357,3199999,6306356
"1524","Turkey",2004,15,3127820,3192363,6320183
"1525","Turkey",2004,20,3147250,3174840,6322090
"1526","Turkey",2004,25,2991387,2971175,5962562
"1527","Turkey",2004,30,2742840,2663604,5406444
"1528","Turkey",2004,35,2413141,2328659,4741800
"1529","Turkey",2004,40,2151663,2021445,4173108
"1530","Turkey",2004,45,1916283,1703755,3620038
"1531","Turkey",2004,50,1652437,1412303,3064740
"1532","Turkey",2004,55,1265388,1117823,2383211
"1533","Turkey",2004,60,1026588,927909,1954497
"1534","Turkey",2004,65,844776,819675,1664451
"1535","Turkey",2004,70,752599,664574,1417173
"1536","Turkey",2004,75,510063,351605,861668
"1537","Turkey",2004,80,264293,139797,404090
"1538","Turkey",2004,85,101991,35606,137597
"1539","Turkey",2004,90,33274,9642,42916
"1540","Turkey",2004,95,5668,830,6498
"1541","Ukraine",1995,0,1360838,1433504,2794342
"1542","Ukraine",1995,5,1706880,1792878,3499758
"1543","Ukraine",1995,10,1870448,1947580,3818028
"1544","Ukraine",1995,15,1834547,1852740,3687287
"1545","Ukraine",1995,20,1750719,1785015,3535734
"1546","Ukraine",1995,25,1645820,1683953,3329773
"1547","Ukraine",1995,30,1847816,1860181,3707997
"1548","Ukraine",1995,35,1968896,1884903,3853799
"1549","Ukraine",1995,40,2067945,1917440,3985385
"1550","Ukraine",1995,45,1608384,1494765,3103149
"1551","Ukraine",1995,50,1371760,1169509,2541269
"1552","Ukraine",1995,55,2076490,1659786,3736276
"1553","Ukraine",1995,60,1375575,1046766,2422341
"1554","Ukraine",1995,65,1732389,1089306,2821695
"1555","Ukraine",1995,70,1279049,561716,1840765
"1556","Ukraine",1995,75,691866,255107,946973
"1557","Ukraine",1995,80,616080,194321,810401
"1558","Ukraine",1995,85,277732,80017,357749
"1559","Ukraine",1995,90,74807,19393,94200
"1560","Ukraine",1995,95,13954,2908,16862
"1561","United Kingdom",2004,0,1686900,1771160,3458060
"1562","United Kingdom",2004,5,1735855,1820169,3556024
"1563","United Kingdom",2004,10,1860142,1964176,3824318
"1564","United Kingdom",2004,15,1923832,2037084,3960916
"1565","United Kingdom",2004,20,1923582,1987709,3911291
"1566","United Kingdom",2004,25,1886172,1876041,3762213
"1567","United Kingdom",2004,30,2104374,2070301,4174675
"1568","United Kingdom",2004,35,2365578,2330275,4695853
"1569","United Kingdom",2004,40,2353319,2299763,4653082
"1570","United Kingdom",2004,45,2011325,1974775,3986100
"1571","United Kingdom",2004,50,1829883,1790333,3620216
"1572","United Kingdom",2004,55,1971655,1921330,3892985
"1573","United Kingdom",2004,60,1598352,1526326,3124678
"1574","United Kingdom",2004,65,1408303,1298062,2706365
"1575","United Kingdom",2004,70,1262722,1094371,2357093
"1576","United Kingdom",2004,75,1114381,851187,1965568
"1577","United Kingdom",2004,80,912322,564599,1476921
"1578","United Kingdom",2004,85,510899,244562,755461
"1579","United Kingdom",2004,90,242228,80877,323105
"1580","United Kingdom",2004,95,68644,14385,83029
"1581","Uruguay",2005,0,123732,129196,252928
"1582","Uruguay",2005,5,128936,134281,263217
"1583","Uruguay",2005,10,132835,138117,270952
"1584","Uruguay",2005,15,126193,130909,257102
"1585","Uruguay",2005,20,118430,121566,239996
"1586","Uruguay",2005,25,124339,125962,250301
"1587","Uruguay",2005,30,117046,117124,234170
"1588","Uruguay",2005,35,106483,101919,208402
"1589","Uruguay",2005,40,108586,102446,211032
"1590","Uruguay",2005,45,103811,96676,200487
"1591","Uruguay",2005,50,91708,85561,177269
"1592","Uruguay",2005,55,85253,75855,161108
"1593","Uruguay",2005,60,77408,66382,143790
"1594","Uruguay",2005,65,71963,55946,127909
"1595","Uruguay",2005,70,68433,49474,117907
"1596","Uruguay",2005,75,58422,36692,95114
"1597","Uruguay",2005,80,39611,21051,60662
"1598","Uruguay",2005,85,21969,8967,30936
"1599","Uruguay",2005,90,10758,3334,14092
"1600","Uruguay",2005,95,3479,946,4425
"1601","USA",2003,0,9907891,10362146,20270037
"1602","USA",2003,5,9656077,10104445,19760522
"1603","USA",2003,10,10512572,11054862,21567434
"1604","USA",2003,15,10473588,11095918,21569506
"1605","USA",2003,20,10069760,10543300,20613060
"1606","USA",2003,25,9669810,9746126,19415936
"1607","USA",2003,30,9801989,9892382,19694371
"1608","USA",2003,35,10297080,10562911,20859991
"1609","USA",2003,40,11183251,11368494,22551745
"1610","USA",2003,45,11165933,11082866,22248799
"1611","USA",2003,50,10170432,9874695,20045127
"1612","USA",2003,55,8866875,8326119,17192994
"1613","USA",2003,60,6784402,6100835,12885237
"1614","USA",2003,65,5415706,4903147,10318853
"1615","USA",2003,70,4679099,3862085,8541184
"1616","USA",2003,75,4256551,3144604,7401155
"1617","USA",2003,80,3306226,2101530,5407756
"1618","USA",2003,85,2050456,1047646,3098102
"1619","USA",2003,90,866352,326557,1192909
"1620","USA",2003,95,291378,67413,358791
