"","Country","Year","Age","Female","Male","Total"
"221","Afghanistan","2020",0,2765103,2907406,5672509
"222","Afghanistan","2020",5,2641593,2774630,5416223
"223","Afghanistan","2020",10,2540450,2651664,5192114
"224","Afghanistan","2020",15,2251504,2377941,4629445
"225","Afghanistan","2020",20,1909206,2017279,3926485
"226","Afghanistan","2020",25,1498590,1610796,3109386
"227","Afghanistan","2020",30,1179138,1299121,2478259
"228","Afghanistan","2020",35,988220,1068167,2056387
"229","Afghanistan","2020",40,790703,868020,1658723
"230","Afghanistan","2020",45,627510,677226,1304736
"231","Afghanistan","2020",50,503171,529188,1032359
"232","Afghanistan","2020",55,396460,411379,807839
"233","Afghanistan","2020",60,307557,305081,612638
"234","Afghanistan","2020",65,229221,215637,444858
"235","Afghanistan","2020",70,172197,140254,312451
"236","Afghanistan","2020",75,91107,76897,168004
"237","Afghanistan","2020",80,42490,33115,75605
"238","Afghanistan","2020",85,14275,10185,24460
"239","Afghanistan","2020",90,3139,2053,5192
"240","Afghanistan","2020",95,442,226,668
"241","Albania","2020",0,79714,86564,166278
"242","Albania","2020",5,79822,87732,167554
"243","Albania","2020",10,75224,86957,162181
"244","Albania","2020",15,93379,106218,199597
"245","Albania","2020",20,110982,117374,228356
"246","Albania","2020",25,115006,129317,244323
"247","Albania","2020",30,101291,122633,223924
"248","Albania","2020",35,76191,90658,166849
"249","Albania","2020",40,76614,75896,152510
"250","Albania","2020",45,90245,80264,170509
"251","Albania","2020",50,95681,88504,184185
"252","Albania","2020",55,103252,98654,201906
"253","Albania","2020",60,95295,91164,186459
"254","Albania","2020",65,73946,69837,143783
"255","Albania","2020",70,55690,52442,108132
"256","Albania","2020",75,45107,41429,86536
"257","Albania","2020",80,28149,25727,53876
"258","Albania","2020",85,12885,10503,23388
"259","Albania","2020",90,4043,2584,6627
"260","Albania","2020",95,570,257,827
"261","Algeria","2020",0,2467456,2574062,5041518
"262","Algeria","2020",5,2269335,2366637,4635972
"263","Algeria","2020",10,1872109,1949293,3821402
"264","Algeria","2020",15,1425863,1484482,2910345
"265","Algeria","2020",20,1468812,1531025,2999837
"266","Algeria","2020",25,1761867,1812011,3573878
"267","Algeria","2020",30,1850199,1877520,3727719
"268","Algeria","2020",35,1764741,1782775,3547516
"269","Algeria","2020",40,1502809,1511220,3014029
"270","Algeria","2020",45,1220495,1214095,2434590
"271","Algeria","2020",50,1035144,1026740,2061884
"272","Algeria","2020",55,870269,867903,1738172
"273","Algeria","2020",60,684035,703307,1387342
"274","Algeria","2020",65,560160,583040,1143200
"275","Algeria","2020",70,364221,359717,723938
"276","Algeria","2020",75,272083,241813,513896
"277","Algeria","2020",80,185844,157783,343627
"278","Algeria","2020",85,90055,80994,171049
"279","Algeria","2020",90,26899,24471,51370
"280","Algeria","2020",95,4839,4920,9759
"281","Argentina","2020",0,1833225,1903426,3736651
"282","Argentina","2020",5,1820688,1889129,3709817
"283","Argentina","2020",10,1766041,1831221,3597262
"284","Argentina","2020",15,1739689,1799760,3539449
"285","Argentina","2020",20,1714597,1762738,3477335
"286","Argentina","2020",25,1745039,1775210,3520249
"287","Argentina","2020",30,1660236,1658744,3318980
"288","Argentina","2020",35,1572135,1550297,3122432
"289","Argentina","2020",40,1571745,1518156,3089901
"290","Argentina","2020",45,1359574,1278269,2637843
"291","Argentina","2020",50,1198262,1103469,2301731
"292","Argentina","2020",55,1119816,1003393,2123209
"293","Argentina","2020",60,1006668,877065,1883733
"294","Argentina","2020",65,899258,745751,1645009
"295","Argentina","2020",70,758347,578876,1337223
"296","Argentina","2020",75,577676,385738,963414
"297","Argentina","2020",80,406456,228228,634684
"298","Argentina","2020",85,251280,113405,364685
"299","Argentina","2020",90,114056,38290,152346
"300","Argentina","2020",95,31843,7981,39824
"301","Australia","2020",0,812208,857499,1669707
"302","Australia","2020",5,798241,841026,1639267
"303","Australia","2020",10,784728,825846,1610574
"304","Australia","2020",15,742431,777475,1519906
"305","Australia","2020",20,783346,811222,1594568
"306","Australia","2020",25,871181,909705,1780886
"307","Australia","2020",30,935876,939585,1875461
"308","Australia","2020",35,921292,921591,1842883
"309","Australia","2020",40,818343,810368,1628711
"310","Australia","2020",45,845813,831536,1677349
"311","Australia","2020",50,789390,768934,1558324
"312","Australia","2020",55,782011,767400,1549411
"313","Australia","2020",60,724814,693712,1418526
"314","Australia","2020",65,630854,601807,1232661
"315","Australia","2020",70,555787,527592,1083379
"316","Australia","2020",75,397186,365811,762997
"317","Australia","2020",80,281672,241273,522945
"318","Australia","2020",85,192294,136756,329050
"319","Australia","2020",90,100294,56263,156557
"320","Australia","2020",95,33495,13224,46719
"321","Austria","2020",0,217802,230364,448166
"322","Austria","2020",5,206020,219996,426016
"323","Austria","2020",10,205043,218795,423838
"324","Austria","2020",15,218866,233504,452370
"325","Austria","2020",20,245500,263261,508761
"326","Austria","2020",25,294550,312066,606616
"327","Austria","2020",30,304547,315827,620374
"328","Austria","2020",35,308423,314619,623042
"329","Austria","2020",40,281246,284438,565684
"330","Austria","2020",45,307276,305305,612581
"331","Austria","2020",50,356193,357250,713443
"332","Austria","2020",55,346719,346838,693557
"333","Austria","2020",60,297693,284670,582363
"334","Austria","2020",65,237002,213955,450957
"335","Austria","2020",70,219951,187337,407288
"336","Austria","2020",75,214616,168533,383149
"337","Austria","2020",80,153112,107116,260228
"338","Austria","2020",85,90259,52214,142473
"339","Austria","2020",90,47474,19835,67309
"340","Austria","2020",95,14417,3768,18185
"341","Bangladesh","2020",0,7007986,7320193,14328179
"342","Bangladesh","2020",5,7167474,7476957,14644431
"343","Bangladesh","2020",10,7381842,7707436,15089278
"344","Bangladesh","2020",15,7609850,7975294,15585144
"345","Bangladesh","2020",20,7496756,7742470,15239226
"346","Bangladesh","2020",25,7268120,7257687,14525807
"347","Bangladesh","2020",30,6984129,6778960,13763089
"348","Bangladesh","2020",35,6477367,6271177,12748544
"349","Bangladesh","2020",40,5671765,5553520,11225285
"350","Bangladesh","2020",45,4707604,4718381,9425985
"351","Bangladesh","2020",50,4040065,4264730,8304795
"352","Bangladesh","2020",55,3221413,3479495,6700908
"353","Bangladesh","2020",60,2128534,2371855,4500389
"354","Bangladesh","2020",65,1306839,1489609,2796448
"355","Bangladesh","2020",70,1150261,1206898,2357159
"356","Bangladesh","2020",75,883532,855121,1738653
"357","Bangladesh","2020",80,533685,487662,1021347
"358","Bangladesh","2020",85,265965,217066,483031
"359","Bangladesh","2020",90,98950,68178,167128
"360","Bangladesh","2020",95,28138,16419,44557
"1","Belgium","2019",0,57969,60380,118349
"2","Belgium","2019",5,243329,255083,498412
"3","Belgium","2019",10,326204,341523,667727
"4","Belgium","2019",15,321097,336907,658004
"5","Belgium","2019",20,308350,324576,632926
"6","Belgium","2019",25,330053,343335,673388
"7","Belgium","2019",30,372819,377385,750204
"8","Belgium","2019",35,369687,371039,740726
"9","Belgium","2019",40,375545,379677,755222
"10","Belgium","2019",45,363596,370403,733999
"11","Belgium","2019",50,384620,394692,779312
"12","Belgium","2019",55,396998,407126,804124
"13","Belgium","2019",60,395710,396261,791971
"14","Belgium","2019",65,360618,350239,710857
"15","Belgium","2019",70,317182,298705,615887
"16","Belgium","2019",75,281670,250001,531671
"17","Belgium","2019",80,206071,165310,371381
"18","Belgium","2019",85,188251,131165,319416
"19","Belgium","2019",90,138532,76750,215282
"20","Belgium","2019",95,81439.07,30900.94,112340.01
"361","Bolivia","2020",0,579535,605964,1185499
"362","Bolivia","2020",5,576763,602325,1179088
"363","Bolivia","2020",10,568242,592770,1161012
"364","Bolivia","2020",15,557073,579611,1136684
"365","Bolivia","2020",20,524085,541104,1065189
"366","Bolivia","2020",25,481351,492994,974345
"367","Bolivia","2020",30,432517,438428,870945
"368","Bolivia","2020",35,383096,385058,768154
"369","Bolivia","2020",40,334572,333313,667885
"370","Bolivia","2020",45,287248,283210,570458
"371","Bolivia","2020",50,243093,237469,480562
"372","Bolivia","2020",55,204984,198046,403030
"373","Bolivia","2020",60,172470,163721,336191
"374","Bolivia","2020",65,144891,134236,279127
"375","Bolivia","2020",70,118349,107091,225440
"376","Bolivia","2020",75,89556,76945,166501
"377","Bolivia","2020",80,59746,47160,106906
"378","Bolivia","2020",85,35052,24975,60027
"379","Bolivia","2020",90,16229,10304,26533
"380","Bolivia","2020",95,6158,3295,9453
"381","Brazil","2020",0,7070447,7404646,14475093
"382","Brazil","2020",5,7136977,7464840,14601817
"383","Brazil","2020",10,7319056,7623386,14942442
"384","Brazil","2020",15,7964694,8253310,16218004
"385","Brazil","2020",20,8466492,8685557,17152049
"386","Brazil","2020",25,8418590,8534004,16952594
"387","Brazil","2020",30,8576223,8571684,17147907
"388","Brazil","2020",35,8735133,8593722,17328855
"389","Brazil","2020",40,7956785,7704528,15661313
"390","Brazil","2020",45,7079054,6721639,13800693
"391","Brazil","2020",50,6651999,6170933,12822932
"392","Brazil","2020",55,6089814,5508456,11598270
"393","Brazil","2020",60,5044879,4423280,9468159
"394","Brazil","2020",65,4034221,3394482,7428703
"395","Brazil","2020",70,2957955,2351464,5309419
"396","Brazil","2020",75,2011193,1480939,3492132
"397","Brazil","2020",80,1395700,921508,2317208
"398","Brazil","2020",85,752233,423007,1175240
"399","Brazil","2020",90,349826,161001,510827
"400","Brazil","2020",95,112355,43397,155752
"401","Burkina Faso","2020",0,1705602,1766880,3472482
"402","Burkina Faso","2020",5,1512775,1566931,3079706
"403","Burkina Faso","2020",10,1336467,1386191,2722658
"404","Burkina Faso","2020",15,1130961,1175924,2306885
"405","Burkina Faso","2020",20,944924,974970,1919894
"406","Burkina Faso","2020",25,786300,801871,1588171
"407","Burkina Faso","2020",30,658052,662313,1320365
"408","Burkina Faso","2020",35,556513,551155,1107668
"409","Burkina Faso","2020",40,454452,438595,893047
"410","Burkina Faso","2020",45,359962,334124,694086
"411","Burkina Faso","2020",50,293828,259751,553579
"412","Burkina Faso","2020",55,232524,191387,423911
"413","Burkina Faso","2020",60,180748,136094,316842
"414","Burkina Faso","2020",65,132069,89966,222035
"415","Burkina Faso","2020",70,89431,58590,148021
"416","Burkina Faso","2020",75,53376,32840,86216
"417","Burkina Faso","2020",80,22988,13145,36133
"418","Burkina Faso","2020",85,6443,3430,9873
"419","Burkina Faso","2020",90,1062,517,1579
"420","Burkina Faso","2020",95,88,39,127
"421","Cameroon","2020",0,2037881,2077822,4115703
"422","Cameroon","2020",5,1848488,1881835,3730323
"423","Cameroon","2020",10,1647542,1672667,3320209
"424","Cameroon","2020",15,1420203,1436047,2856250
"425","Cameroon","2020",20,1206119,1213879,2419998
"426","Cameroon","2020",25,1064780,1067009,2131789
"427","Cameroon","2020",30,930208,930610,1860818
"428","Cameroon","2020",35,768732,770292,1539024
"429","Cameroon","2020",40,600746,602489,1203235
"430","Cameroon","2020",45,470252,468356,938608
"431","Cameroon","2020",50,368259,360872,729131
"432","Cameroon","2020",55,286649,272697,559346
"433","Cameroon","2020",60,219795,200605,420400
"434","Cameroon","2020",65,167533,145366,312899
"435","Cameroon","2020",70,115950,93962,209912
"436","Cameroon","2020",75,70169,52653,122822
"437","Cameroon","2020",80,33831,22958,56789
"438","Cameroon","2020",85,10149,6152,16301
"439","Cameroon","2020",90,1426,767,2193
"440","Cameroon","2020",95,77,37,114
"441","Canada","2020",0,972207,1020925,1993132
"442","Canada","2020",5,966024,1011765,1977789
"443","Canada","2020",10,968771,1014230,1983001
"444","Canada","2020",15,971038,1017281,1988319
"445","Canada","2020",20,1155236,1208233,2363469
"446","Canada","2020",25,1343606,1389541,2733147
"447","Canada","2020",30,1310409,1315956,2626365
"448","Canada","2020",35,1330404,1321892,2652296
"449","Canada","2020",40,1239077,1224232,2463309
"450","Canada","2020",45,1193687,1189671,2383358
"451","Canada","2020",50,1207497,1215983,2423480
"452","Canada","2020",55,1378179,1380774,2758953
"453","Canada","2020",60,1287326,1275239,2562565
"454","Canada","2020",65,1102782,1047397,2150179
"455","Canada","2020",70,925427,867426,1792853
"456","Canada","2020",75,657537,568286,1225823
"457","Canada","2020",80,458654,355943,814597
"458","Canada","2020",85,313372,205330,518702
"459","Canada","2020",90,169081,83600,252681
"460","Canada","2020",95,59665,18474,78139
"461","Chad","2020",0,1454928,1475507,2930435
"462","Chad","2020",5,1256678,1265436,2522114
"463","Chad","2020",10,1089596,1094282,2183878
"464","Chad","2020",15,925954,928896,1854850
"465","Chad","2020",20,765776,769725,1535501
"466","Chad","2020",25,622402,623114,1245516
"467","Chad","2020",30,494224,495761,989985
"468","Chad","2020",35,388793,390868,779661
"469","Chad","2020",40,304121,305919,610040
"470","Chad","2020",45,237352,235439,472791
"471","Chad","2020",50,184641,177726,362367
"472","Chad","2020",55,151875,140405,292280
"473","Chad","2020",60,125262,110762,236024
"474","Chad","2020",65,98556,82769,181325
"475","Chad","2020",70,60228,51956,112184
"476","Chad","2020",75,37340,31137,68477
"477","Chad","2020",80,18953,14662,33615
"478","Chad","2020",85,7029,4740,11769
"479","Chad","2020",90,1708,953,2661
"480","Chad","2020",95,273,113,386
"481","Chile","2020",0,570363,591860,1162223
"482","Chile","2020",5,621865,643991,1265856
"483","Chile","2020",10,614053,635584,1249637
"484","Chile","2020",15,611781,632461,1244242
"485","Chile","2020",20,690833,712076,1402909
"486","Chile","2020",25,783760,808869,1592629
"487","Chile","2020",30,760568,785253,1545821
"488","Chile","2020",35,692548,707035,1399583
"489","Chile","2020",40,661077,663019,1324096
"490","Chile","2020",45,632832,621476,1254308
"491","Chile","2020",50,619294,595301,1214595
"492","Chile","2020",55,587199,550477,1137676
"493","Chile","2020",60,514838,467461,982299
"494","Chile","2020",65,432902,376586,809488
"495","Chile","2020",70,317940,263359,581299
"496","Chile","2020",75,235874,175953,411827
"497","Chile","2020",80,166728,107532,274260
"498","Chile","2020",85,104882,57264,162146
"499","Chile","2020",90,53137,24091,77228
"500","Chile","2020",95,18066,6021,24087
"501","China","2020",0,39476105,44456332,83932437
"502","China","2020",5,40415039,46320144,86735183
"503","China","2020",10,38912828,45349923,84262751
"504","China","2020",15,38238737,44103122,82341859
"505","China","2020",20,40884302,46273865,87158167
"506","China","2020",25,46466160,51522843,97989003
"507","China","2020",30,62295742,66443228,128738970
"508","China","2020",35,48745948,51345507,100091455
"509","China","2020",40,46984787,49289359,96274146
"510","China","2020",45,58664268,61173349,119837617
"511","China","2020",50,61097362,62348020,123445382
"512","China","2020",55,48782446,49958045,98740491
"513","China","2020",60,38596854,38917285,77514139
"514","China","2020",65,37622978,36526788,74149766
"515","China","2020",70,23524526,21425163,44949689
"516","China","2020",75,14337340,12207276,26544616
"517","China","2020",80,9297788,6883629,16181417
"518","China","2020",85,4738693,2843084,7581777
"519","China","2020",90,1573796,731228,2305024
"520","China","2020",95,420735,129150,549885
"521","Colombia","2020",0,1811777,1898922,3710699
"522","Colombia","2020",5,1809772,1893684,3703456
"523","Colombia","2020",10,1894697,1978788,3873485
"524","Colombia","2020",15,2079569,2166822,4246391
"525","Colombia","2020",20,2174898,2246568,4421466
"526","Colombia","2020",25,2190587,2235008,4425595
"527","Colombia","2020",30,2024696,2032111,4056807
"528","Colombia","2020",35,1903244,1850248,3753492
"529","Colombia","2020",40,1773283,1647786,3421069
"530","Colombia","2020",45,1607487,1422231,3029718
"531","Colombia","2020",50,1537390,1371075,2908465
"532","Colombia","2020",55,1395717,1239798,2635515
"533","Colombia","2020",60,1129431,957019,2086450
"534","Colombia","2020",65,913137,771771,1684908
"535","Colombia","2020",70,649780,537856,1187636
"536","Colombia","2020",75,445769,346356,792125
"537","Colombia","2020",80,298000,218269,516269
"538","Colombia","2020",85,166494,112047,278541
"539","Colombia","2020",90,70447,45208,115655
"540","Colombia","2020",95,22145,12997,35142
"541","Costa Rica","2020",0,169903,178099,348002
"542","Costa Rica","2020",5,174632,182964,357596
"543","Costa Rica","2020",10,173617,181789,355406
"544","Costa Rica","2020",15,177679,185752,363431
"545","Costa Rica","2020",20,196168,204063,400231
"546","Costa Rica","2020",25,208623,215602,424225
"547","Costa Rica","2020",30,212671,217910,430581
"548","Costa Rica","2020",35,196071,199003,395074
"549","Costa Rica","2020",40,174005,174231,348236
"550","Costa Rica","2020",45,153100,149226,302326
"551","Costa Rica","2020",50,155306,149636,304942
"552","Costa Rica","2020",55,151756,145697,297453
"553","Costa Rica","2020",60,125401,118906,244307
"554","Costa Rica","2020",65,92722,85979,178701
"555","Costa Rica","2020",70,72696,65944,138640
"556","Costa Rica","2020",75,49691,42534,92225
"557","Costa Rica","2020",80,33405,26505,59910
"558","Costa Rica","2020",85,19497,13883,33380
"559","Costa Rica","2020",90,9004,5685,14689
"560","Costa Rica","2020",95,3091,1668,4759
"561","Croatia","2020",0,89324,94827,184151
"562","Croatia","2020",5,97512,104113,201625
"563","Croatia","2020",10,102835,108359,211194
"564","Croatia","2020",15,95710,101202,196912
"565","Croatia","2020",20,115038,121093,236131
"566","Croatia","2020",25,115469,120600,236069
"567","Croatia","2020",30,126747,130772,257519
"568","Croatia","2020",35,138483,143289,281772
"569","Croatia","2020",40,141862,146275,288137
"570","Croatia","2020",45,133973,134892,268865
"571","Croatia","2020",50,142310,138704,281014
"572","Croatia","2020",55,154873,145496,300369
"573","Croatia","2020",60,151474,137574,289048
"574","Croatia","2020",65,147120,129210,276330
"575","Croatia","2020",70,117175,88861,206036
"576","Croatia","2020",75,95319,60600,155919
"577","Croatia","2020",80,86614,47278,133892
"578","Croatia","2020",85,51508,19697,71205
"579","Croatia","2020",90,19324,5710,25034
"580","Croatia","2020",95,3306,740,4046
"581","Cuba","2020",0,277783,293500,571283
"582","Cuba","2020",5,305433,322660,628093
"583","Cuba","2020",10,293422,310481,603903
"584","Cuba","2020",15,312225,330604,642829
"585","Cuba","2020",20,341084,360184,701268
"586","Cuba","2020",25,347272,372479,719751
"587","Cuba","2020",30,407710,423331,831041
"588","Cuba","2020",35,340043,351949,691992
"589","Cuba","2020",40,304963,312681,617644
"590","Cuba","2020",45,470453,473885,944338
"591","Cuba","2020",50,508990,489484,998474
"592","Cuba","2020",55,498368,470453,968821
"593","Cuba","2020",60,314749,292245,606994
"594","Cuba","2020",65,300742,266286,567028
"595","Cuba","2020",70,238901,210228,449129
"596","Cuba","2020",75,192755,162323,355078
"597","Cuba","2020",80,129719,99845,229564
"598","Cuba","2020",85,70939,50687,121626
"599","Cuba","2020",90,34117,22061,56178
"600","Cuba","2020",95,13480,8102,21582
"601","Cyprus","2020",0,31431,33386,64817
"602","Cyprus","2020",5,32815,34761,67576
"603","Cyprus","2020",10,32838,34917,67755
"604","Cyprus","2020",15,35464,38438,73902
"605","Cyprus","2020",20,43849,49613,93462
"606","Cyprus","2020",25,46448,51892,98340
"607","Cyprus","2020",30,46569,49887,96456
"608","Cyprus","2020",35,46631,45302,91933
"609","Cyprus","2020",40,44924,42313,87237
"610","Cyprus","2020",45,40375,39016,79391
"611","Cyprus","2020",50,38864,36918,75782
"612","Cyprus","2020",55,35538,36218,71756
"613","Cyprus","2020",60,33494,31495,64989
"614","Cyprus","2020",65,28359,27053,55412
"615","Cyprus","2020",70,24216,21628,45844
"616","Cyprus","2020",75,17951,14886,32837
"617","Cyprus","2020",80,13204,9967,23171
"618","Cyprus","2020",85,7198,4281,11479
"619","Cyprus","2020",90,2957,1312,4269
"620","Cyprus","2020",95,722,231,953
"21","Czechia","2019",0,55699,58167,113866
"22","Czechia","2019",5,220778,232528,453306
"23","Czechia","2019",10,279079,292895,571974
"24","Czechia","2019",15,269794,284120,553914
"25","Czechia","2019",20,227173,240218,467391
"26","Czechia","2019",25,242645,255372,498017
"27","Czechia","2019",30,325537,343440,668977
"28","Czechia","2019",35,351422,373769,725191
"29","Czechia","2019",40,380714,406261,786975
"30","Czechia","2019",45,456041,481362,937403
"31","Czechia","2019",50,382802,404233,787035
"32","Czechia","2019",55,339749,352218,691967
"33","Czechia","2019",60,313641,314566,628207
"34","Czechia","2019",65,350778,328182,678960
"35","Czechia","2019",70,364441,315501,679942
"36","Czechia","2019",75,330966,258907,589873
"37","Czechia","2019",80,226982,156913,383895
"38","Czechia","2019",85,145219,83949,229168
"39","Czechia","2019",90,96420,45812,142232
"40","Czechia","2019",95,45725.92,15780.93,61506.85
"41","Denmark","2020",0,29817,31649,61466
"42","Denmark","2020",5,119785,126637,246422
"43","Denmark","2020",10,149474,157127,306601
"44","Denmark","2020",15,164885,173744,338629
"45","Denmark","2020",20,167639,175643,343282
"46","Denmark","2020",25,186937,194954,381891
"47","Denmark","2020",30,196402,204408,400810
"48","Denmark","2020",35,175511,182835,358346
"49","Denmark","2020",40,162485,165977,328462
"50","Denmark","2020",45,181674,182485,364159
"51","Denmark","2020",50,195744,196145,391889
"52","Denmark","2020",55,204373,207533,411906
"53","Denmark","2020",60,193719,194819,388538
"54","Denmark","2020",65,173710,170661,344371
"55","Denmark","2020",70,163541,155734,319275
"56","Denmark","2020",75,168091,156463,324554
"57","Denmark","2020",80,128223,111613,239836
"58","Denmark","2020",85,83207,64756,147963
"59","Denmark","2020",90,48573,30762,79335
"60","Denmark","2020",95,32055,12973,45028
"621","Dominican Republic","2020",0,491041,511788,1002829
"622","Dominican Republic","2020",5,488284,508235,996519
"623","Dominican Republic","2020",10,478988,498257,977245
"624","Dominican Republic","2020",15,470057,488573,958630
"625","Dominican Republic","2020",20,462350,477213,939563
"626","Dominican Republic","2020",25,456260,458494,914754
"627","Dominican Republic","2020",30,415916,409657,825573
"628","Dominican Republic","2020",35,366422,372387,738809
"629","Dominican Republic","2020",40,336561,331702,668263
"630","Dominican Republic","2020",45,307628,298598,606226
"631","Dominican Republic","2020",50,277336,264099,541435
"632","Dominican Republic","2020",55,243099,229801,472900
"633","Dominican Republic","2020",60,199918,188646,388564
"634","Dominican Republic","2020",65,152487,141088,293575
"635","Dominican Republic","2020",70,107760,96390,204150
"636","Dominican Republic","2020",75,73762,63588,137350
"637","Dominican Republic","2020",80,52296,42550,94846
"638","Dominican Republic","2020",85,29842,23065,52907
"639","Dominican Republic","2020",90,13464,9850,23314
"640","Dominican Republic","2020",95,6227,4225,10452
"641","Ecuador","2020",0,814607,852480,1667087
"642","Ecuador","2020",5,787672,822971,1610643
"643","Ecuador","2020",10,760867,794178,1555045
"644","Ecuador","2020",15,765542,795398,1560940
"645","Ecuador","2020",20,770693,795841,1566534
"646","Ecuador","2020",25,727724,741930,1469654
"647","Ecuador","2020",30,679034,684119,1363153
"648","Ecuador","2020",35,615341,614345,1229686
"649","Ecuador","2020",40,554097,544919,1099016
"650","Ecuador","2020",45,501771,487453,989224
"651","Ecuador","2020",50,440121,424183,864304
"652","Ecuador","2020",55,372034,354801,726835
"653","Ecuador","2020",60,310214,291420,601634
"654","Ecuador","2020",65,253078,233026,486104
"655","Ecuador","2020",70,173174,154896,328070
"656","Ecuador","2020",75,130493,111561,242054
"657","Ecuador","2020",80,84427,67833,152260
"658","Ecuador","2020",85,47230,35155,82385
"659","Ecuador","2020",90,21406,13671,35077
"660","Ecuador","2020",95,9708,3647,13355
"661","El Salvador","2020",0,281360,294856,576216
"662","El Salvador","2020",5,278571,292036,570607
"663","El Salvador","2020",10,282959,294937,577896
"664","El Salvador","2020",15,292083,295844,587927
"665","El Salvador","2020",20,322236,310848,633084
"666","El Salvador","2020",25,306826,275904,582730
"667","El Salvador","2020",30,259845,214396,474241
"668","El Salvador","2020",35,230009,178192,408201
"669","El Salvador","2020",40,216711,164893,381604
"670","El Salvador","2020",45,196050,147488,343538
"671","El Salvador","2020",50,173922,129205,303127
"672","El Salvador","2020",55,152687,112257,264944
"673","El Salvador","2020",60,128074,92893,220967
"674","El Salvador","2020",65,108836,76493,185329
"675","El Salvador","2020",70,81497,58108,139605
"676","El Salvador","2020",75,63097,45689,108786
"677","El Salvador","2020",80,42858,31750,74608
"678","El Salvador","2020",85,22372,15345,37717
"679","El Salvador","2020",90,7839,4500,12339
"680","El Salvador","2020",95,1945,790,2735
"681","Estonia","2020",0,33343,35833,69176
"682","Estonia","2020",5,36408,38077,74485
"683","Estonia","2020",10,36459,38734,75193
"684","Estonia","2020",15,30318,31977,62295
"685","Estonia","2020",20,28443,29565,58008
"686","Estonia","2020",25,41275,46271,87546
"687","Estonia","2020",30,47859,53711,101570
"688","Estonia","2020",35,44529,47532,92061
"689","Estonia","2020",40,42895,45678,88573
"690","Estonia","2020",45,47347,49018,96365
"691","Estonia","2020",50,38963,37452,76415
"692","Estonia","2020",55,46595,42273,88868
"693","Estonia","2020",60,47121,38604,85725
"694","Estonia","2020",65,49283,34464,83747
"695","Estonia","2020",70,32620,20527,53147
"696","Estonia","2020",75,36151,18131,54282
"697","Estonia","2020",80,31160,12348,43508
"698","Estonia","2020",85,17631,5796,23427
"699","Estonia","2020",90,7998,2148,10146
"700","Estonia","2020",95,1685,317,2002
"701","Eswatini","2020",0,71155,72522,143677
"702","Eswatini","2020",5,70984,71959,142943
"703","Eswatini","2020",10,73683,74096,147779
"704","Eswatini","2020",15,63873,65366,129239
"705","Eswatini","2020",20,54059,58758,112817
"706","Eswatini","2020",25,48320,51750,100070
"707","Eswatini","2020",30,44471,38083,82554
"708","Eswatini","2020",35,44737,34038,78775
"709","Eswatini","2020",40,33949,26255,60204
"710","Eswatini","2020",45,22424,21771,44195
"711","Eswatini","2020",50,12971,16623,29594
"712","Eswatini","2020",55,9997,12126,22123
"713","Eswatini","2020",60,9663,9976,19639
"714","Eswatini","2020",65,9478,7405,16883
"715","Eswatini","2020",70,8467,5084,13551
"716","Eswatini","2020",75,6145,2889,9034
"717","Eswatini","2020",80,3726,1178,4904
"718","Eswatini","2020",85,1471,308,1779
"719","Eswatini","2020",90,316,45,361
"720","Eswatini","2020",95,39,4,43
"721","Ethiopia","2020",0,8271178,8520306,16791484
"722","Ethiopia","2020",5,7525556,7720508,15246064
"723","Ethiopia","2020",10,6854126,6999073,13853199
"724","Ethiopia","2020",15,6432598,6543197,12975795
"725","Ethiopia","2020",20,5816173,5930683,11746856
"726","Ethiopia","2020",25,4802450,4889739,9692189
"727","Ethiopia","2020",30,3757544,3761349,7518893
"728","Ethiopia","2020",35,3182837,3091148,6273985
"729","Ethiopia","2020",40,2488422,2445523,4933945
"730","Ethiopia","2020",45,2033228,2071480,4104708
"731","Ethiopia","2020",50,1660957,1567789,3228746
"732","Ethiopia","2020",55,1316318,1159002,2475320
"733","Ethiopia","2020",60,1109670,946594,2056264
"734","Ethiopia","2020",65,832543,735747,1568290
"735","Ethiopia","2020",70,648561,539874,1188435
"736","Ethiopia","2020",75,400726,340207,740933
"737","Ethiopia","2020",80,202974,168831,371805
"738","Ethiopia","2020",85,84730,67383,152113
"739","Ethiopia","2020",90,22462,16275,38737
"740","Ethiopia","2020",95,3695,2127,5822
"61","Finland","2019",0,23000,24663,47663
"62","Finland","2019",5,107629,112394,220023
"63","Finland","2019",10,151005,158005,309010
"64","Finland","2019",15,149356,156182,305538
"65","Finland","2019",20,144041,152126,296167
"66","Finland","2019",25,155877,164499,320376
"67","Finland","2019",30,172237,182635,354872
"68","Finland","2019",35,169564,180832,350396
"69","Finland","2019",40,172424,183327,355751
"70","Finland","2019",45,166596,175769,342365
"71","Finland","2019",50,155005,160573,315578
"72","Finland","2019",55,181247,183302,364549
"73","Finland","2019",60,185077,183156,368233
"74","Finland","2019",65,185506,177055,362561
"75","Finland","2019",70,187930,174278,362208
"76","Finland","2019",75,176154,154506,330660
"77","Finland","2019",80,117326,91933,209259
"78","Finland","2019",85,92842,62247,155089
"79","Finland","2019",90,63302,32747,96049
"80","Finland","2019",95,38511,13061,51572
"741","France","2020",0,1769564,1850423,3619987
"742","France","2020",5,1911573,1995914,3907487
"743","France","2020",10,1950961,2044727,3995688
"744","France","2020",15,1901843,1985946,3887789
"745","France","2020",20,1828067,1868952,3697019
"746","France","2020",25,1851937,1822073,3674010
"747","France","2020",30,2009584,1931949,3941533
"748","France","2020",35,2074165,1995352,4069517
"749","France","2020",40,1999757,1943640,3943397
"750","France","2020",45,2213131,2169139,4382270
"751","France","2020",50,2216970,2146431,4363401
"752","France","2020",55,2192447,2079209,4271656
"753","France","2020",60,2070457,1902791,3973248
"754","France","2020",65,2005687,1785851,3791538
"755","France","2020",70,1896420,1627196,3523616
"756","France","2020",75,1222283,981805,2204088
"757","France","2020",80,1071980,740347,1812327
"758","France","2020",85,854083,475731,1329814
"759","France","2020",90,470532,194367,664899
"760","France","2020",95,172876,47352,220228
"761","Germany","2020",0,1976336,2082343,4058679
"762","Germany","2020",5,1851880,1970345,3822225
"763","Germany","2020",10,1832305,1979340,3811645
"764","Germany","2020",15,1968750,2150221,4118971
"765","Germany","2020",20,2170940,2382496,4553436
"766","Germany","2020",25,2302127,2521798,4823925
"767","Germany","2020",30,2619021,2822844,5441865
"768","Germany","2020",35,2655700,2774455,5430155
"769","Germany","2020",40,2507865,2551802,5059667
"770","Germany","2020",45,2576014,2607670,5183684
"771","Germany","2020",50,3328288,3352933,6681221
"772","Germany","2020",55,3413966,3393206,6807172
"773","Germany","2020",60,2965997,2854706,5820703
"774","Germany","2020",65,2532358,2291081,4823439
"775","Germany","2020",70,2042707,1791116,3833823
"776","Germany","2020",75,2005707,1631884,3637591
"777","Germany","2020",80,1899975,1359119,3259094
"778","Germany","2020",85,1022253,612796,1635049
"779","Germany","2020",90,521588,236559,758147
"780","Germany","2020",95,174257,49197,223454
"781","Greece","2020",0,198284,211175,409459
"782","Greece","2020",5,228093,243575,471668
"783","Greece","2020",10,262836,279401,542237
"784","Greece","2020",15,257254,269364,526618
"785","Greece","2020",20,258966,270450,529416
"786","Greece","2020",25,251021,276779,527800
"787","Greece","2020",30,287614,310198,597812
"788","Greece","2020",35,361715,376988,738703
"789","Greece","2020",40,383856,396607,780463
"790","Greece","2020",45,396830,397116,793946
"791","Greece","2020",50,403434,392909,796343
"792","Greece","2020",55,366665,342686,709351
"793","Greece","2020",60,356447,320081,676528
"794","Greece","2020",65,311925,268709,580634
"795","Greece","2020",70,296795,252669,549464
"796","Greece","2020",75,223536,183083,406619
"797","Greece","2020",80,229478,164914,394392
"798","Greece","2020",85,155597,105159,260756
"799","Greece","2020",90,61478,43491,104969
"800","Greece","2020",95,15406,10472,25878
"801","Haiti","2020",0,619176,643767,1262943
"802","Haiti","2020",5,608270,629566,1237836
"803","Haiti","2020",10,592092,609977,1202069
"804","Haiti","2020",15,568686,575774,1144460
"805","Haiti","2020",20,536373,528825,1065198
"806","Haiti","2020",25,496324,482935,979259
"807","Haiti","2020",30,460863,444936,905799
"808","Haiti","2020",35,422311,403546,825857
"809","Haiti","2020",40,324778,302438,627216
"810","Haiti","2020",45,252256,227015,479271
"811","Haiti","2020",50,221153,202596,423749
"812","Haiti","2020",55,192453,173422,365875
"813","Haiti","2020",60,153332,139622,292954
"814","Haiti","2020",65,123615,107363,230978
"815","Haiti","2020",70,83849,66963,150812
"816","Haiti","2020",75,61432,47971,109403
"817","Haiti","2020",80,36140,25550,61690
"818","Haiti","2020",85,16100,10402,26502
"819","Haiti","2020",90,5323,3046,8369
"820","Haiti","2020",95,1562,731,2293
"821","Hungary","2020",0,224090,237052,461142
"822","Hungary","2020",5,218060,229364,447424
"823","Hungary","2020",10,235637,247724,483361
"824","Hungary","2020",15,236115,249731,485846
"825","Hungary","2020",20,252381,265562,517943
"826","Hungary","2020",25,309831,323916,633747
"827","Hungary","2020",30,299168,312996,612164
"828","Hungary","2020",35,319807,325171,644978
"829","Hungary","2020",40,404943,409741,814684
"830","Hungary","2020",45,385111,388418,773529
"831","Hungary","2020",50,329688,318463,648151
"832","Hungary","2020",55,290102,263135,553237
"833","Hungary","2020",60,348757,287562,636319
"834","Hungary","2020",65,381229,288884,670113
"835","Hungary","2020",70,285020,190751,475771
"836","Hungary","2020",75,235574,135231,370805
"837","Hungary","2020",80,165548,74196,239744
"838","Hungary","2020",85,95391,36684,132075
"839","Hungary","2020",90,34963,10818,45781
"840","Hungary","2020",95,10647,2889,13536
"841","Iceland","2020",0,9958,10481,20439
"842","Iceland","2020",5,11138,11493,22631
"843","Iceland","2020",10,11232,11981,23213
"844","Iceland","2020",15,10607,10888,21495
"845","Iceland","2020",20,10890,11349,22239
"846","Iceland","2020",25,12401,13158,25559
"847","Iceland","2020",30,11456,11850,23306
"848","Iceland","2020",35,11524,12041,23565
"849","Iceland","2020",40,10834,10982,21816
"850","Iceland","2020",45,10435,10715,21150
"851","Iceland","2020",50,10455,10271,20726
"852","Iceland","2020",55,10873,10512,21385
"853","Iceland","2020",60,10231,10180,20411
"854","Iceland","2020",65,8521,8604,17125
"855","Iceland","2020",70,6917,7024,13941
"856","Iceland","2020",75,4980,4494,9474
"857","Iceland","2020",80,3340,2809,6149
"858","Iceland","2020",85,2529,1743,4272
"859","Iceland","2020",90,1160,675,1835
"860","Iceland","2020",95,364,155,519
"861","India","2020",0,55651093,61228414,116879507
"862","India","2020",5,56104958,61877169,117982127
"863","India","2020",10,59853324,66302628,126155952
"864","India","2020",15,59374711,66670855,126045566
"865","India","2020",20,57638993,64865811,122504804
"866","India","2020",25,55357930,62039339,117397269
"867","India","2020",30,53301210,58874888,112176098
"868","India","2020",35,49466260,53993918,103460178
"869","India","2020",40,43588651,46631243,90219894
"870","India","2020",45,38683675,40756605,79440280
"871","India","2020",50,33673299,35202663,68875962
"872","India","2020",55,29105996,30150272,59256268
"873","India","2020",60,24195856,24694672,48890528
"874","India","2020",65,19092154,19168129,38260283
"875","India","2020",70,12463535,11627908,24091443
"876","India","2020",75,8020956,7062999,15083955
"877","India","2020",80,4657548,3831463,8489011
"878","India","2020",85,1955555,1575584,3531139
"879","India","2020",90,555797,437188,992985
"880","India","2020",95,161914,109222,271136
"881","Indonesia","2020",0,11565560,12092736,23658296
"882","Indonesia","2020",5,11886870,12411280,24298150
"883","Indonesia","2020",10,11174785,11809874,22984659
"884","Indonesia","2020",15,11310294,12008052,23318346
"885","Indonesia","2020",20,11027508,11625762,22653270
"886","Indonesia","2020",25,10278030,10640126,20918156
"887","Indonesia","2020",30,10018019,9955229,19973248
"888","Indonesia","2020",35,10603161,10590213,21193374
"889","Indonesia","2020",40,9787218,9893522,19680740
"890","Indonesia","2020",45,8996891,9169094,18165985
"891","Indonesia","2020",50,7947047,8007935,15954982
"892","Indonesia","2020",55,6659928,6540189,13200117
"893","Indonesia","2020",60,5245489,5149357,10394846
"894","Indonesia","2020",65,3575894,3560471,7136365
"895","Indonesia","2020",70,2525488,2092055,4617543
"896","Indonesia","2020",75,1685010,1271922,2956932
"897","Indonesia","2020",80,1002254,629423,1631677
"898","Indonesia","2020",85,384796,208338,593134
"899","Indonesia","2020",90,113431,55562,168993
"900","Indonesia","2020",95,18087,6721,24808
"901","Iraq","2020",0,2612357,2768066,5380423
"902","Iraq","2020",5,2542391,2687416,5229807
"903","Iraq","2020",10,2218133,2341048,4559181
"904","Iraq","2020",15,2022766,2128810,4151576
"905","Iraq","2020",20,1858446,1941425,3799871
"906","Iraq","2020",25,1646730,1718989,3365719
"907","Iraq","2020",30,1434787,1492575,2927362
"908","Iraq","2020",35,1214222,1262099,2476321
"909","Iraq","2020",40,1061171,1088847,2150018
"910","Iraq","2020",45,896244,890358,1786602
"911","Iraq","2020",50,730586,684409,1414995
"912","Iraq","2020",55,495864,430293,926157
"913","Iraq","2020",60,363398,306318,669716
"914","Iraq","2020",65,339984,282693,622677
"915","Iraq","2020",70,178363,153582,331945
"916","Iraq","2020",75,134949,106824,241773
"917","Iraq","2020",80,74910,51696,126606
"918","Iraq","2020",85,30321,18072,48393
"919","Iraq","2020",90,7773,3751,11524
"920","Iraq","2020",95,1330,507,1837
"921","Ireland","2020",0,152093,161560,313653
"922","Ireland","2020",5,174421,183869,358290
"923","Ireland","2020",10,174656,182055,356711
"924","Ireland","2020",15,153162,158874,312036
"925","Ireland","2020",20,143018,146666,289684
"926","Ireland","2020",25,136455,141198,277653
"927","Ireland","2020",30,156015,154931,310946
"928","Ireland","2020",35,198057,186925,384982
"929","Ireland","2020",40,202944,192610,395554
"930","Ireland","2020",45,185755,181919,367674
"931","Ireland","2020",50,156798,155399,312197
"932","Ireland","2020",55,145604,143132,288736
"933","Ireland","2020",60,126855,122993,249848
"934","Ireland","2020",65,117548,113389,230937
"935","Ireland","2020",70,101042,95764,196806
"936","Ireland","2020",75,69974,63883,133857
"937","Ireland","2020",80,48452,39656,88108
"938","Ireland","2020",85,26790,18940,45730
"939","Ireland","2020",90,12304,6086,18390
"940","Ireland","2020",95,4504,1500,6004
"941","Israel","2020",0,413202,434626,847828
"942","Israel","2020",5,400498,422770,823268
"943","Israel","2020",10,358769,378840,737609
"944","Israel","2020",15,324764,342690,667454
"945","Israel","2020",20,303852,320121,623973
"946","Israel","2020",25,279872,293130,573002
"947","Israel","2020",30,279304,285404,564708
"948","Israel","2020",35,278798,278739,557537
"949","Israel","2020",40,273338,270334,543672
"950","Israel","2020",45,250510,245995,496505
"951","Israel","2020",50,212038,205483,417521
"952","Israel","2020",55,194444,183531,377975
"953","Israel","2020",60,183871,166086,349957
"954","Israel","2020",65,188121,165565,353686
"955","Israel","2020",70,154276,134423,288699
"956","Israel","2020",75,93793,77168,170961
"957","Israel","2020",80,72517,51897,124414
"958","Israel","2020",85,51177,32673,83850
"959","Israel","2020",90,26033,14093,40126
"960","Israel","2020",95,8247,4549,12796
"961","Italy","2020",0,1127405,1197289,2324694
"962","Italy","2020",5,1295570,1374731,2670301
"963","Italy","2020",10,1387183,1470174,2857357
"964","Italy","2020",15,1391636,1484455,2876091
"965","Italy","2020",20,1415929,1526577,2942506
"966","Italy","2020",25,1535700,1625230,3160930
"967","Italy","2020",30,1662536,1702976,3365512
"968","Italy","2020",35,1808649,1824273,3632922
"969","Italy","2020",40,2096655,2092329,4188984
"970","Italy","2020",45,2431950,2401070,4833020
"971","Italy","2020",50,2487780,2420466,4908246
"972","Italy","2020",55,2384062,2274884,4658946
"973","Italy","2020",60,2050522,1903045,3953567
"974","Italy","2020",65,1851695,1679600,3531295
"975","Italy","2020",70,1805038,1586760,3391798
"976","Italy","2020",75,1454787,1182323,2637110
"977","Italy","2020",80,1344033,958360,2302393
"978","Italy","2020",85,893202,504059,1397261
"979","Italy","2020",90,453131,186608,639739
"980","Italy","2020",95,146640,42516,189156
"981","Jamaica","2020",0,112917,117906,230823
"982","Jamaica","2020",5,114585,119381,233966
"983","Jamaica","2020",10,111730,115152,226882
"984","Jamaica","2020",15,117374,122344,239718
"985","Jamaica","2020",20,128126,133044,261170
"986","Jamaica","2020",25,125259,129067,254326
"987","Jamaica","2020",30,115034,117460,232494
"988","Jamaica","2020",35,108307,102582,210889
"989","Jamaica","2020",40,94551,84021,178572
"990","Jamaica","2020",45,93547,85311,178858
"991","Jamaica","2020",50,89150,82115,171265
"992","Jamaica","2020",55,76113,73155,149268
"993","Jamaica","2020",60,66463,57662,124125
"994","Jamaica","2020",65,46183,44233,90416
"995","Jamaica","2020",70,36142,34577,70719
"996","Jamaica","2020",75,25375,23427,48802
"997","Jamaica","2020",80,16936,15156,32092
"998","Jamaica","2020",85,9440,8305,17745
"999","Jamaica","2020",90,3597,3729,7326
"1000","Jamaica","2020",95,691,1014,1705
"81","Japan","2019",0,446918.91,470112.68,917031.59
"82","Japan","2019",5,1869947.06,1962574.79,3832521.85
"83","Japan","2019",10,2487475.51,2609026.41,5096501.92
"84","Japan","2019",15,2597792.87,2724928.12,5322720.99
"85","Japan","2019",20,2813424.24,2966586.73,5780010.97
"86","Japan","2019",25,2901874.57,3065442.06,5967316.63
"87","Japan","2019",30,2880590.48,3009542.43,5890132.91
"88","Japan","2019",35,3255573.12,3380340.8,6635913.92
"89","Japan","2019",40,3659274.61,3783463.83,7442738.44
"90","Japan","2019",45,4337974.33,4485993.03,8823967.36
"91","Japan","2019",50,4698121.71,4835382.71,9533504.42
"92","Japan","2019",55,4100862.04,4174168.96,8275031
"93","Japan","2019",60,3779947.77,3785177.01,7565124.78
"94","Japan","2019",65,3796802.52,3705624.4,7502426.92
"95","Japan","2019",70,4721238.38,4426520.76,9147759.14
"96","Japan","2019",75,4400236.06,3906799.59,8307035.65
"97","Japan","2019",80,3857119.25,3121876,6978995.25
"98","Japan","2019",85,3137064.54,2189035.97,5326100.51
"99","Japan","2019",90,2295379.56,1234837.16,3530216.72
"100","Japan","2019",95,1666970.28,547219.12,2214189.4
"1001","Kenya","2020",0,3486021,3558343,7044364
"1002","Kenya","2020",5,3461279,3508267,6969546
"1003","Kenya","2020",10,3340913,3395310,6736223
"1004","Kenya","2020",15,2988795,3021861,6010656
"1005","Kenya","2020",20,2617391,2619202,5236593
"1006","Kenya","2020",25,2190500,2167181,4357681
"1007","Kenya","2020",30,2030044,1992648,4022692
"1008","Kenya","2020",35,1743029,1704425,3447454
"1009","Kenya","2020",40,1397049,1362401,2759450
"1010","Kenya","2020",45,1088429,1055166,2143595
"1011","Kenya","2020",50,821975,782098,1604073
"1012","Kenya","2020",55,627839,573691,1201530
"1013","Kenya","2020",60,477352,410863,888215
"1014","Kenya","2020",65,351130,279481,630611
"1015","Kenya","2020",70,220032,161035,381067
"1016","Kenya","2020",75,116868,76404,193272
"1017","Kenya","2020",80,65195,36529,101724
"1018","Kenya","2020",85,24571,11823,36394
"1019","Kenya","2020",90,4106,1702,5808
"1020","Kenya","2020",95,255,97,352
"1021","Latvia","2020",0,54579,59441,114020
"1022","Latvia","2020",5,45018,48731,93749
"1023","Latvia","2020",10,49615,52557,102172
"1024","Latvia","2020",15,42712,43840,86552
"1025","Latvia","2020",20,33372,36159,69531
"1026","Latvia","2020",25,57397,61295,118692
"1027","Latvia","2020",30,69510,72749,142259
"1028","Latvia","2020",35,59546,61417,120963
"1029","Latvia","2020",40,61129,59619,120748
"1030","Latvia","2020",45,68512,64627,133139
"1031","Latvia","2020",50,62553,56624,119177
"1032","Latvia","2020",55,78577,66488,145065
"1033","Latvia","2020",60,73215,56716,129931
"1034","Latvia","2020",65,72450,47763,120213
"1035","Latvia","2020",70,47888,26833,74721
"1036","Latvia","2020",75,60410,27573,87983
"1037","Latvia","2020",80,35036,14438,49474
"1038","Latvia","2020",85,26638,8335,34973
"1039","Latvia","2020",90,14240,3372,17612
"1040","Latvia","2020",95,4469,759,5228
"1041","Lithuania","2020",0,70376,74742,145118
"1042","Lithuania","2020",5,75414,80143,155557
"1043","Lithuania","2020",10,59154,61526,120680
"1044","Lithuania","2020",15,59115,63046,122161
"1045","Lithuania","2020",20,65192,68453,133645
"1046","Lithuania","2020",25,87266,95967,183233
"1047","Lithuania","2020",30,89530,96833,186363
"1048","Lithuania","2020",35,73018,78184,151202
"1049","Lithuania","2020",40,81052,80127,161179
"1050","Lithuania","2020",45,100556,94174,194730
"1051","Lithuania","2020",50,96838,88016,184854
"1052","Lithuania","2020",55,127997,107707,235704
"1053","Lithuania","2020",60,105453,81130,186583
"1054","Lithuania","2020",65,99981,66247,166228
"1055","Lithuania","2020",70,69856,38601,108457
"1056","Lithuania","2020",75,77646,37180,114826
"1057","Lithuania","2020",80,55337,28005,83342
"1058","Lithuania","2020",85,42104,13723,55827
"1059","Lithuania","2020",90,20679,5078,25757
"1060","Lithuania","2020",95,5740,1105,6845
"1061","Luxembourg","2020",0,16147,17102,33249
"1062","Luxembourg","2020",5,15924,16733,32657
"1063","Luxembourg","2020",10,15519,15962,31481
"1064","Luxembourg","2020",15,16735,17685,34420
"1065","Luxembourg","2020",20,19254,20581,39835
"1066","Luxembourg","2020",25,22072,23626,45698
"1067","Luxembourg","2020",30,24496,24642,49138
"1068","Luxembourg","2020",35,24516,24662,49178
"1069","Luxembourg","2020",40,22437,24118,46555
"1070","Luxembourg","2020",45,22746,25299,48045
"1071","Luxembourg","2020",50,22698,25485,48183
"1072","Luxembourg","2020",55,20690,21983,42673
"1073","Luxembourg","2020",60,17152,17629,34781
"1074","Luxembourg","2020",65,13623,13719,27342
"1075","Luxembourg","2020",70,11456,10767,22223
"1076","Luxembourg","2020",75,8601,7049,15650
"1077","Luxembourg","2020",80,7013,5240,12253
"1078","Luxembourg","2020",85,5220,3155,8375
"1079","Luxembourg","2020",90,2469,1002,3471
"1080","Luxembourg","2020",95,621,148,769
"1081","Malawi","2020",0,1446930,1477013,2923943
"1082","Malawi","2020",5,1356955,1381621,2738576
"1083","Malawi","2020",10,1275213,1286629,2561842
"1084","Malawi","2020",15,1088192,1088019,2176211
"1085","Malawi","2020",20,924780,913937,1838717
"1086","Malawi","2020",25,782145,756656,1538801
"1087","Malawi","2020",30,662669,629760,1292429
"1088","Malawi","2020",35,510020,483574,993594
"1089","Malawi","2020",40,414080,392707,806787
"1090","Malawi","2020",45,325490,304464,629954
"1091","Malawi","2020",50,254522,226793,481315
"1092","Malawi","2020",55,197398,167435,364833
"1093","Malawi","2020",60,153834,123788,277622
"1094","Malawi","2020",65,115063,87563,202626
"1095","Malawi","2020",70,91018,61748,152766
"1096","Malawi","2020",75,57678,33798,91476
"1097","Malawi","2020",80,28719,14084,42803
"1098","Malawi","2020",85,9465,3889,13354
"1099","Malawi","2020",90,1634,528,2162
"1100","Malawi","2020",95,113,31,144
"1101","Malta","2020",0,10530,11144,21674
"1102","Malta","2020",5,10310,11118,21428
"1103","Malta","2020",10,9826,10539,20365
"1104","Malta","2020",15,10053,10509,20562
"1105","Malta","2020",20,12136,12914,25050
"1106","Malta","2020",25,14418,15744,30162
"1107","Malta","2020",30,15813,17114,32927
"1108","Malta","2020",35,15581,16845,32426
"1109","Malta","2020",40,15110,16043,31153
"1110","Malta","2020",45,13764,14529,28293
"1111","Malta","2020",50,12300,12736,25036
"1112","Malta","2020",55,14006,14170,28176
"1113","Malta","2020",60,15183,14948,30131
"1114","Malta","2020",65,13912,13637,27549
"1115","Malta","2020",70,14514,13456,27970
"1116","Malta","2020",75,9330,7866,17196
"1117","Malta","2020",80,6742,4900,11642
"1118","Malta","2020",85,4218,2301,6519
"1119","Malta","2020",90,1817,736,2553
"1120","Malta","2020",95,556,171,727
"1121","Mexico","2020",0,5353961,5604781,10958742
"1122","Mexico","2020",5,5478805,5731706,11210511
"1123","Mexico","2020",10,5448048,5692822,11140870
"1124","Mexico","2020",15,5514580,5695013,11209593
"1125","Mexico","2020",20,5434658,5505161,10939819
"1126","Mexico","2020",25,5411644,5384130,10795774
"1127","Mexico","2020",30,5041468,4748412,9789880
"1128","Mexico","2020",35,4746361,4343789,9090150
"1129","Mexico","2020",40,4502226,4029738,8531964
"1130","Mexico","2020",45,4233025,3782769,8015794
"1131","Mexico","2020",50,3688873,3236044,6924917
"1132","Mexico","2020",55,3090563,2742491,5833054
"1133","Mexico","2020",60,2500183,2169271,4669454
"1134","Mexico","2020",65,1938297,1657202,3595499
"1135","Mexico","2020",70,1340716,1125991,2466707
"1136","Mexico","2020",75,947528,774478,1722006
"1137","Mexico","2020",80,602438,456066,1058504
"1138","Mexico","2020",85,361118,248866,609984
"1139","Mexico","2020",90,168098,107034,275132
"1140","Mexico","2020",95,58677,35722,94399
"1141","Moldova","2020",0,98566,103954,202520
"1142","Moldova","2020",5,107224,114314,221538
"1143","Moldova","2020",10,105482,111388,216870
"1144","Moldova","2020",15,97800,104616,202416
"1145","Moldova","2020",20,118028,123090,241118
"1146","Moldova","2020",25,161950,167765,329715
"1147","Moldova","2020",30,205820,212169,417989
"1148","Moldova","2020",35,175173,180714,355887
"1149","Moldova","2020",40,152172,149505,301677
"1150","Moldova","2020",45,134822,126309,261131
"1151","Moldova","2020",50,124559,109905,234464
"1152","Moldova","2020",55,156775,129776,286551
"1153","Moldova","2020",60,146074,112051,258125
"1154","Moldova","2020",65,136354,93810,230164
"1155","Moldova","2020",70,64243,41172,105415
"1156","Moldova","2020",75,52643,26931,79574
"1157","Moldova","2020",80,37753,15512,53265
"1158","Moldova","2020",85,18604,7108,25712
"1159","Moldova","2020",90,6785,1678,8463
"1160","Moldova","2020",95,1183,186,1369
"1161","Nepal","2020",0,1321065,1385708,2706773
"1162","Nepal","2020",5,1370347,1385863,2756210
"1163","Nepal","2020",10,1457119,1474130,2931249
"1164","Nepal","2020",15,1584067,1604814,3188881
"1165","Nepal","2020",20,1685226,1536298,3221524
"1166","Nepal","2020",25,1529827,1135023,2664850
"1167","Nepal","2020",30,1293059,776203,2069262
"1168","Nepal","2020",35,1119714,603766,1723480
"1169","Nepal","2020",40,991336,605690,1597026
"1170","Nepal","2020",45,826074,622553,1448627
"1171","Nepal","2020",50,683964,579427,1263391
"1172","Nepal","2020",55,558896,485413,1044309
"1173","Nepal","2020",60,440788,382303,823091
"1174","Nepal","2020",65,352428,312559,664987
"1175","Nepal","2020",70,264099,209634,473733
"1176","Nepal","2020",75,187118,150684,337802
"1177","Nepal","2020",80,82646,69868,152514
"1178","Nepal","2020",85,31290,22860,54150
"1179","Nepal","2020",90,8139,5124,13263
"1180","Nepal","2020",95,1171,515,1686
"101","Netherlands","2019",0,82270,86173,168443
"102","Netherlands","2019",5,340134,357485,697619
"103","Netherlands","2019",10,447209,470233,917442
"104","Netherlands","2019",15,466784,489531,956315
"105","Netherlands","2019",20,513715,538304,1052019
"106","Netherlands","2019",25,531643,548282,1079925
"107","Netherlands","2019",30,552792,569071,1121863
"108","Netherlands","2019",35,533531,543375,1076906
"109","Netherlands","2019",40,514558,516735,1031293
"110","Netherlands","2019",45,514928,510460,1025388
"111","Netherlands","2019",50,619179,616540,1235719
"112","Netherlands","2019",55,634869,641987,1276856
"113","Netherlands","2019",60,614931,616601,1231532
"114","Netherlands","2019",65,550840,545999,1096839
"115","Netherlands","2019",70,501068,492006,993074
"116","Netherlands","2019",75,467968,445416,913384
"117","Netherlands","2019",80,323806,284920,608726
"118","Netherlands","2019",85,240960,181154,422114
"119","Netherlands","2019",90,158510,91558,250068
"120","Netherlands","2019",95,91381.98,35255.97,126637.95
"1181","New Zealand","2020",0,146564,154692,301256
"1182","New Zealand","2020",5,152978,161050,314028
"1183","New Zealand","2020",10,156370,165337,321707
"1184","New Zealand","2020",15,148767,154479,303246
"1185","New Zealand","2020",20,158120,166357,324477
"1186","New Zealand","2020",25,168383,178375,346758
"1187","New Zealand","2020",30,162979,161465,324444
"1188","New Zealand","2020",35,153265,141357,294622
"1189","New Zealand","2020",40,145220,133195,278415
"1190","New Zealand","2020",45,164756,148703,313459
"1191","New Zealand","2020",50,163187,148794,311981
"1192","New Zealand","2020",55,163783,152927,316710
"1193","New Zealand","2020",60,146025,135788,281813
"1194","New Zealand","2020",65,124444,116055,240499
"1195","New Zealand","2020",70,110490,103116,213606
"1196","New Zealand","2020",75,78304,69922,148226
"1197","New Zealand","2020",80,53904,43416,97320
"1198","New Zealand","2020",85,32294,23029,55323
"1199","New Zealand","2020",90,17167,10011,27178
"1200","New Zealand","2020",95,5070,2095,7165
"1201","Nicaragua","2020",0,321431,335511,656942
"1202","Nicaragua","2020",5,321436,338768,660204
"1203","Nicaragua","2020",10,308558,328582,637140
"1204","Nicaragua","2020",15,291125,311896,603021
"1205","Nicaragua","2020",20,283773,300937,584710
"1206","Nicaragua","2020",25,286865,294425,581290
"1207","Nicaragua","2020",30,275734,273325,549059
"1208","Nicaragua","2020",35,259982,246411,506393
"1209","Nicaragua","2020",40,222055,199140,421195
"1210","Nicaragua","2020",45,184568,157274,341842
"1211","Nicaragua","2020",50,150066,123835,273901
"1212","Nicaragua","2020",55,128296,105123,233419
"1213","Nicaragua","2020",60,109643,89687,199330
"1214","Nicaragua","2020",65,83986,65436,149422
"1215","Nicaragua","2020",70,47176,36235,83411
"1216","Nicaragua","2020",75,38314,28777,67091
"1217","Nicaragua","2020",80,25087,17719,42806
"1218","Nicaragua","2020",85,13669,8286,21955
"1219","Nicaragua","2020",90,5921,2736,8657
"1220","Nicaragua","2020",95,2020,746,2766
"1221","Nigeria","2020",0,16561329,17377466,33938795
"1222","Nigeria","2020",5,14625985,15287661,29913646
"1223","Nigeria","2020",10,12633388,13159355,25792743
"1224","Nigeria","2020",15,10758964,11151483,21910447
"1225","Nigeria","2020",20,8898293,9170281,18068574
"1226","Nigeria","2020",25,7448235,7660610,15108845
"1227","Nigeria","2020",30,6430540,6613972,13044512
"1228","Nigeria","2020",35,5578185,5745353,11323538
"1229","Nigeria","2020",40,4672877,4785766,9458643
"1230","Nigeria","2020",45,3771400,3807418,7578818
"1231","Nigeria","2020",50,2995570,2947899,5943469
"1232","Nigeria","2020",55,2426334,2330368,4756702
"1233","Nigeria","2020",60,1892087,1764536,3656623
"1234","Nigeria","2020",65,1369452,1232451,2601903
"1235","Nigeria","2020",70,900588,816324,1716912
"1236","Nigeria","2020",75,480358,426433,906791
"1237","Nigeria","2020",80,179349,153999,333348
"1238","Nigeria","2020",85,41370,34068,75438
"1239","Nigeria","2020",90,5232,3939,9171
"1240","Nigeria","2020",95,414,255,669
"121","Norway","2019",0,26835,28556,55391
"122","Norway","2019",5,116176,123296,239472
"123","Norway","2019",10,155970,164083,320053
"124","Norway","2019",15,155981,164061,320042
"125","Norway","2019",20,155334,165165,320499
"126","Norway","2019",25,164895,176336,341231
"127","Norway","2019",30,181578,189610,371188
"128","Norway","2019",35,178708,186264,364972
"129","Norway","2019",40,170931,181466,352397
"130","Norway","2019",45,170461,179750,350211
"131","Norway","2019",50,184354,194074,378428
"132","Norway","2019",55,178097,187947,366044
"133","Norway","2019",60,159560,166140,325700
"134","Norway","2019",65,151153,152590,303743
"135","Norway","2019",70,136879,136125,273004
"136","Norway","2019",75,130391,125400,255791
"137","Norway","2019",80,87319,76728,164047
"138","Norway","2019",85,62110,47100,109210
"139","Norway","2019",90,44612,27209,71821
"140","Norway","2019",95,31795,13173,44968
"1241","Pakistan","2020",0,13453556,14509296,27962852
"1242","Pakistan","2020",5,12273189,13226191,25499380
"1243","Pakistan","2020",10,11296757,12154761,23451518
"1244","Pakistan","2020",15,10532903,11443015,21975918
"1245","Pakistan","2020",20,10030306,10741968,20772274
"1246","Pakistan","2020",25,9337097,9820991,19158088
"1247","Pakistan","2020",30,8221159,8597168,16818327
"1248","Pakistan","2020",35,6853394,7144302,13997696
"1249","Pakistan","2020",40,5692604,5922918,11615522
"1250","Pakistan","2020",45,4728045,4905180,9633225
"1251","Pakistan","2020",50,4054023,4176690,8230713
"1252","Pakistan","2020",55,3405944,3485956,6891900
"1253","Pakistan","2020",60,2613081,2666009,5279090
"1254","Pakistan","2020",65,1801861,1821463,3623324
"1255","Pakistan","2020",70,1333665,1372079,2705744
"1256","Pakistan","2020",75,913614,939571,1853185
"1257","Pakistan","2020",80,466969,494894,961863
"1258","Pakistan","2020",85,171740,193109,364849
"1259","Pakistan","2020",90,36341,48962,85303
"1260","Pakistan","2020",95,4076,7484,11560
"1261","Panama","2020",0,190263,199050,389313
"1262","Panama","2020",5,188074,196392,384466
"1263","Panama","2020",10,180822,188589,369411
"1264","Panama","2020",15,175437,181761,357198
"1265","Panama","2020",20,172474,176589,349063
"1266","Panama","2020",25,163390,165802,329192
"1267","Panama","2020",30,157818,159313,317131
"1268","Panama","2020",35,149904,151560,301464
"1269","Panama","2020",40,143892,144232,288124
"1270","Panama","2020",45,134387,133884,268271
"1271","Panama","2020",50,118129,116515,234644
"1272","Panama","2020",55,100706,97629,198335
"1273","Panama","2020",60,82042,77685,159727
"1274","Panama","2020",65,64068,58837,122905
"1275","Panama","2020",70,48444,43175,91619
"1276","Panama","2020",75,35646,30543,66189
"1277","Panama","2020",80,24336,19680,44016
"1278","Panama","2020",85,14602,11130,25732
"1279","Panama","2020",90,7197,5213,12410
"1280","Panama","2020",95,3257,2301,5558
"1281","Peru","2020",0,1383397,1449868,2833265
"1282","Peru","2020",5,1302683,1309452,2612135
"1283","Peru","2020",10,1370496,1325559,2696055
"1284","Peru","2020",15,1256814,1181735,2438549
"1285","Peru","2020",20,1399118,1208975,2608093
"1286","Peru","2020",25,1406343,1361349,2767692
"1287","Peru","2020",30,1320411,1372968,2693379
"1288","Peru","2020",35,1228709,1309074,2537783
"1289","Peru","2020",40,1120269,1180561,2300830
"1290","Peru","2020",45,997909,1047925,2045834
"1291","Peru","2020",50,892086,900044,1792130
"1292","Peru","2020",55,763847,757902,1521749
"1293","Peru","2020",60,630354,617118,1247472
"1294","Peru","2020",65,527783,501384,1029167
"1295","Peru","2020",70,379331,352748,732079
"1296","Peru","2020",75,279578,243752,523330
"1297","Peru","2020",80,184203,161173,345376
"1298","Peru","2020",85,103410,71136,174546
"1299","Peru","2020",90,36747,21842,58589
"1300","Peru","2020",95,9752,4041,13793
"1301","Philippines","2020",0,5165709,5450633,10616342
"1302","Philippines","2020",5,5551880,5846072,11397952
"1303","Philippines","2020",10,5328550,5578251,10906801
"1304","Philippines","2020",15,5055235,5407659,10462894
"1305","Philippines","2020",20,4912579,5191755,10104334
"1306","Philippines","2020",25,4672169,4807611,9479780
"1307","Philippines","2020",30,4080419,4166778,8247197
"1308","Philippines","2020",35,3610181,3644549,7254730
"1309","Philippines","2020",40,3254622,3297341,6551963
"1310","Philippines","2020",45,2875542,2883722,5759264
"1311","Philippines","2020",50,2578054,2538943,5116997
"1312","Philippines","2020",55,2174061,2075862,4249923
"1313","Philippines","2020",60,1778415,1614771,3393186
"1314","Philippines","2020",65,1348668,1137017,2485685
"1315","Philippines","2020",70,951813,709616,1661429
"1316","Philippines","2020",75,597110,381080,978190
"1317","Philippines","2020",80,378173,202363,580536
"1318","Philippines","2020",85,165698,75335,241033
"1319","Philippines","2020",90,59191,16873,76064
"1320","Philippines","2020",95,14191,2594,16785
"1321","Poland","2020",0,917595,967319,1884914
"1322","Poland","2020",5,926364,973593,1899957
"1323","Poland","2020",10,963232,1011282,1974514
"1324","Poland","2020",15,852940,881682,1734622
"1325","Poland","2020",20,970664,995319,1965983
"1326","Poland","2020",25,1202068,1263507,2465575
"1327","Poland","2020",30,1355691,1470157,2825848
"1328","Poland","2020",35,1532510,1646565,3179075
"1329","Poland","2020",40,1455923,1502714,2958637
"1330","Poland","2020",45,1285107,1291697,2576804
"1331","Poland","2020",50,1127887,1110610,2238497
"1332","Poland","2020",55,1196275,1128396,2324671
"1333","Poland","2020",60,1445025,1280235,2725260
"1334","Poland","2020",65,1354358,1094529,2448887
"1335","Poland","2020",70,1076251,779602,1855853
"1336","Poland","2020",75,645087,399586,1044673
"1337","Poland","2020",80,584927,299133,884060
"1338","Poland","2020",85,391930,165615,557545
"1339","Poland","2020",90,177355,61846,239201
"1340","Poland","2020",95,47533,14496,62029
"141","Portugal","2019",0,42743,44222,86965
"142","Portugal","2019",5,167706,175790,343496
"143","Portugal","2019",10,228539,238215,466754
"144","Portugal","2019",15,249639,260712,510351
"145","Portugal","2019",20,270414,282330,552744
"146","Portugal","2019",25,265978,272727,538705
"147","Portugal","2019",30,274710,272620,547330
"148","Portugal","2019",35,293745,282370,576115
"149","Portugal","2019",40,357170,328594,685764
"150","Portugal","2019",45,419405,381711,801116
"151","Portugal","2019",50,406993,368384,775377
"152","Portugal","2019",55,395886,354097,749983
"153","Portugal","2019",60,386514,342424,728938
"154","Portugal","2019",65,357656,311098,668754
"155","Portugal","2019",70,333878,284295,618173
"156","Portugal","2019",75,301711,236729,538440
"157","Portugal","2019",80,246993,179163,426156
"158","Portugal","2019",85,214396,136786,351182
"159","Portugal","2019",90,140857,74197,215054
"160","Portugal","2019",95,69318.09,25901.98,95220.07
"1341","Romania","2020",0,456823,482783,939606
"1342","Romania","2020",5,469158,496283,965441
"1343","Romania","2020",10,525496,555265,1080761
"1344","Romania","2020",15,483242,511303,994545
"1345","Romania","2020",20,487348,522529,1009877
"1346","Romania","2020",25,513762,562625,1076387
"1347","Romania","2020",30,666993,729163,1396156
"1348","Romania","2020",35,576438,613306,1189744
"1349","Romania","2020",40,750129,773368,1523497
"1350","Romania","2020",45,740160,762811,1502971
"1351","Romania","2020",50,764424,761724,1526148
"1352","Romania","2020",55,537371,505639,1043010
"1353","Romania","2020",60,693885,596075,1289960
"1354","Romania","2020",65,697965,548023,1245988
"1355","Romania","2020",70,541939,385519,927458
"1356","Romania","2020",75,370577,232234,602811
"1357","Romania","2020",80,353460,183530,536990
"1358","Romania","2020",85,181296,93316,274612
"1359","Romania","2020",90,61734,31959,93693
"1360","Romania","2020",95,11570,6457,18027
"1361","Sierra Leone","2020",0,577747,580904,1158651
"1362","Sierra Leone","2020",5,532748,534486,1067234
"1363","Sierra Leone","2020",10,495355,496964,992319
"1364","Sierra Leone","2020",15,435969,438908,874877
"1365","Sierra Leone","2020",20,375779,378242,754021
"1366","Sierra Leone","2020",25,322912,328581,651493
"1367","Sierra Leone","2020",30,272412,281481,553893
"1368","Sierra Leone","2020",35,226910,236247,463157
"1369","Sierra Leone","2020",40,183262,189857,373119
"1370","Sierra Leone","2020",45,149356,150419,299775
"1371","Sierra Leone","2020",50,120179,116214,236393
"1372","Sierra Leone","2020",55,95488,87252,182740
"1373","Sierra Leone","2020",60,73419,62380,135799
"1374","Sierra Leone","2020",65,55065,43161,98226
"1375","Sierra Leone","2020",70,39024,29315,68339
"1376","Sierra Leone","2020",75,23792,16678,40470
"1377","Sierra Leone","2020",80,11291,7283,18574
"1378","Sierra Leone","2020",85,3952,2312,6264
"1379","Sierra Leone","2020",90,938,488,1426
"1380","Sierra Leone","2020",95,148,67,215
"1381","Slovakia","2020",0,138506,145185,283691
"1382","Slovakia","2020",5,138268,144632,282900
"1383","Slovakia","2020",10,137951,144626,282577
"1384","Slovakia","2020",15,128182,134736,262918
"1385","Slovakia","2020",20,141680,149025,290705
"1386","Slovakia","2020",25,178172,186908,365080
"1387","Slovakia","2020",30,200919,209575,410494
"1388","Slovakia","2020",35,212677,224432,437109
"1389","Slovakia","2020",40,222655,235153,457808
"1390","Slovakia","2020",45,198700,204892,403592
"1391","Slovakia","2020",50,174808,172041,346849
"1392","Slovakia","2020",55,186787,175581,362368
"1393","Slovakia","2020",60,192304,169534,361838
"1394","Slovakia","2020",65,184460,148913,333373
"1395","Slovakia","2020",70,138284,98537,236821
"1396","Slovakia","2020",75,102237,59653,161890
"1397","Slovakia","2020",80,67974,32475,100449
"1398","Slovakia","2020",85,40222,16433,56655
"1399","Slovakia","2020",90,13851,5055,18906
"1400","Slovakia","2020",95,2527,1093,3620
"1401","Slovenia","2020",0,49239,52033,101272
"1402","Slovenia","2020",5,52886,56013,108899
"1403","Slovenia","2020",10,50652,53854,104506
"1404","Slovenia","2020",15,44537,47333,91870
"1405","Slovenia","2020",20,46455,49861,96316
"1406","Slovenia","2020",25,53263,55915,109178
"1407","Slovenia","2020",30,64347,69516,133863
"1408","Slovenia","2020",35,71441,78345,149786
"1409","Slovenia","2020",40,74903,83470,158373
"1410","Slovenia","2020",45,69662,77291,146953
"1411","Slovenia","2020",50,74372,76940,151312
"1412","Slovenia","2020",55,74481,75409,149890
"1413","Slovenia","2020",60,72762,72831,145593
"1414","Slovenia","2020",65,70749,68599,139348
"1415","Slovenia","2020",70,52146,45362,97508
"1416","Slovenia","2020",75,45766,34221,79987
"1417","Slovenia","2020",80,36590,22778,59368
"1418","Slovenia","2020",85,25766,11512,37278
"1419","Slovenia","2020",90,11045,3381,14426
"1420","Slovenia","2020",95,2640,566,3206
"1421","South Africa","2020",0,2845952,2918993,5764945
"1422","South Africa","2020",5,2877308,2943352,5820660
"1423","South Africa","2020",10,2721342,2774621,5495963
"1424","South Africa","2020",15,2440831,2472380,4913211
"1425","South Africa","2020",20,2447270,2476821,4924091
"1426","South Africa","2020",25,2588762,2628636,5217398
"1427","South Africa","2020",30,2664079,2710031,5374110
"1428","South Africa","2020",35,2377613,2403602,4781215
"1429","South Africa","2020",40,1917268,1892772,3810040
"1430","South Africa","2020",45,1655021,1578214,3233235
"1431","South Africa","2020",50,1401326,1290806,2692132
"1432","South Africa","2020",55,1183834,1035566,2219400
"1433","South Africa","2020",60,990310,804405,1794715
"1434","South Africa","2020",65,784770,584956,1369726
"1435","South Africa","2020",70,535895,359322,895217
"1436","South Africa","2020",75,367665,213173,580838
"1437","South Africa","2020",80,202849,95571,298420
"1438","South Africa","2020",85,75492,28462,103954
"1439","South Africa","2020",90,14023,4071,18094
"1440","South Africa","2020",95,1068,258,1326
"1441","South Korea","2020",0,922711,974300,1897011
"1442","South Korea","2020",5,1098051,1158751,2256802
"1443","South Korea","2020",10,1101938,1174844,2276782
"1444","South Korea","2020",15,1187207,1289269,2476476
"1445","South Korea","2020",20,1533115,1683129,3216244
"1446","South Korea","2020",25,1629191,1870859,3500050
"1447","South Korea","2020",30,1548938,1733487,3282425
"1448","South Korea","2020",35,1822801,1974613,3797414
"1449","South Korea","2020",40,1909121,2015813,3924934
"1450","South Korea","2020",45,2107488,2186422,4293910
"1451","South Korea","2020",50,2147031,2168485,4315516
"1452","South Korea","2020",55,2078609,2082574,4161183
"1453","South Korea","2020",60,1918662,1855904,3774566
"1454","South Korea","2020",65,1391279,1287861,2679140
"1455","South Korea","2020",70,1068270,929821,1998091
"1456","South Korea","2020",75,897655,664900,1562555
"1457","South Korea","2020",80,679943,403886,1083829
"1458","South Korea","2020",85,379182,160921,540103
"1459","South Korea","2020",90,143170,41739,184909
"1460","South Korea","2020",95,38967,8276,47243
"161","Spain","2019",0,180825,191164,371989
"162","Spain","2019",5,822450,873065,1695515
"163","Spain","2019",10,1141418,1215470,2356888
"164","Spain","2019",15,1213306,1292421,2505727
"165","Spain","2019",20,1129409,1202753,2332162
"166","Spain","2019",25,1118918,1169404,2288322
"167","Spain","2019",30,1251282,1273836,2525118
"168","Spain","2019",35,1406273,1395386,2801659
"169","Spain","2019",40,1719670,1716735,3436405
"170","Spain","2019",45,1969995,2014585,3984580
"171","Spain","2019",50,1887526,1924615,3812141
"172","Spain","2019",55,1824747,1815339,3640086
"173","Spain","2019",60,1661555,1611961,3273516
"174","Spain","2019",65,1445593,1361786,2807379
"175","Spain","2019",70,1258301,1147954,2406255
"176","Spain","2019",75,1176044,1011942,2187986
"177","Spain","2019",80,908113,722339,1630452
"178","Spain","2019",85,810037,553031,1363068
"179","Spain","2019",90,623153,357472,980625
"180","Spain","2019",95,379187.98,158002.08,537190.06
"1461","Suriname","2020",0,25139,27047,52186
"1462","Suriname","2020",5,25376,27269,52645
"1463","Suriname","2020",10,24867,26727,51594
"1464","Suriname","2020",15,24377,26260,50637
"1465","Suriname","2020",20,23513,25223,48736
"1466","Suriname","2020",25,23061,23975,47036
"1467","Suriname","2020",30,20904,22065,42969
"1468","Suriname","2020",35,20002,19815,39817
"1469","Suriname","2020",40,17624,17579,35203
"1470","Suriname","2020",45,18967,18554,37521
"1471","Suriname","2020",50,16327,16536,32863
"1472","Suriname","2020",55,16291,15674,31965
"1473","Suriname","2020",60,11069,10532,21601
"1474","Suriname","2020",65,8402,6925,15327
"1475","Suriname","2020",70,6435,4908,11343
"1476","Suriname","2020",75,4479,2863,7342
"1477","Suriname","2020",80,2950,1761,4711
"1478","Suriname","2020",85,1380,798,2178
"1479","Suriname","2020",90,515,256,771
"1480","Suriname","2020",95,134,55,189
"181","Sweden","2019",0,56807,60032,116839
"182","Sweden","2019",5,236655,251004,487659
"183","Sweden","2019",10,300939,318534,619473
"184","Sweden","2019",15,289113,306645,595758
"185","Sweden","2019",20,265711,293802,559513
"186","Sweden","2019",25,286425,311168,597593
"187","Sweden","2019",30,360374,380948,741322
"188","Sweden","2019",35,335686,354455,690141
"189","Sweden","2019",40,312107,328012,640119
"190","Sweden","2019",45,311921,323915,635836
"191","Sweden","2019",50,324649,333690,658339
"192","Sweden","2019",55,338662,349187,687849
"193","Sweden","2019",60,296233,302734,598967
"194","Sweden","2019",65,282369,282697,565066
"195","Sweden","2019",70,277788,271523,549311
"196","Sweden","2019",75,288177,275471,563648
"197","Sweden","2019",80,209682,190937,400619
"198","Sweden","2019",85,146321,115206,261527
"199","Sweden","2019",90,99528,62775,162303
"200","Sweden","2019",95,68600,29703,98303
"201","Switzerland","2019",0,42048,44120,86168
"202","Switzerland","2019",5,171080,180632,351712
"203","Switzerland","2019",10,209297,221007,430304
"204","Switzerland","2019",15,202067,213495,415562
"205","Switzerland","2019",20,205936,219776,425712
"206","Switzerland","2019",25,234345,249100,483445
"207","Switzerland","2019",30,280334,288954,569288
"208","Switzerland","2019",35,300338,306152,606490
"209","Switzerland","2019",40,301305,307401,608706
"210","Switzerland","2019",45,290066,293717,583783
"211","Switzerland","2019",50,308700,311949,620649
"212","Switzerland","2019",55,332252,338894,671146
"213","Switzerland","2019",60,303032,307700,610732
"214","Switzerland","2019",65,252356,251173,503529
"215","Switzerland","2019",70,221435,206561,427996
"216","Switzerland","2019",75,209268,188848,398116
"217","Switzerland","2019",80,168111,139426,307537
"218","Switzerland","2019",85,128022,92810,220832
"219","Switzerland","2019",90,90198,52618,142816
"220","Switzerland","2019",95,57216.06,22788.02,80004.08
"1481","Taiwan","2020",0,487138,523999,1011137
"1482","Taiwan","2020",5,500809,540940,1041749
"1483","Taiwan","2020",10,469056,506747,975803
"1484","Taiwan","2020",15,580686,632322,1213008
"1485","Taiwan","2020",20,720696,781583,1502279
"1486","Taiwan","2020",25,784468,833607,1618075
"1487","Taiwan","2020",30,796459,825166,1621625
"1488","Taiwan","2020",35,962739,964222,1926961
"1489","Taiwan","2020",40,1026833,1005619,2032452
"1490","Taiwan","2020",45,886114,869277,1755391
"1491","Taiwan","2020",50,914157,892481,1806638
"1492","Taiwan","2020",55,952391,900189,1852580
"1493","Taiwan","2020",60,863471,820905,1684376
"1494","Taiwan","2020",65,749357,667281,1416638
"1495","Taiwan","2020",70,468598,434532,903130
"1496","Taiwan","2020",75,330413,255257,585670
"1497","Taiwan","2020",80,254040,184145,438185
"1498","Taiwan","2020",85,147580,124436,272016
"1499","Taiwan","2020",90,66579,55474,122053
"1500","Taiwan","2020",95,20878,16131,37009
"1501","Togo","2020",0,608386,611674,1220060
"1502","Togo","2020",5,558500,561621,1120121
"1503","Togo","2020",10,510126,513865,1023991
"1504","Togo","2020",15,443717,447288,891005
"1505","Togo","2020",20,370592,373141,743733
"1506","Togo","2020",25,315163,316365,631528
"1507","Togo","2020",30,283651,283604,567255
"1508","Togo","2020",35,249497,247805,497302
"1509","Togo","2020",40,209402,205162,414564
"1510","Togo","2020",45,168046,161907,329953
"1511","Togo","2020",50,131103,123729,254832
"1512","Togo","2020",55,102250,93632,195882
"1513","Togo","2020",60,78350,69662,148012
"1514","Togo","2020",65,57840,50085,107925
"1515","Togo","2020",70,38952,32819,71771
"1516","Togo","2020",75,21789,17933,39722
"1517","Togo","2020",80,9111,7068,16179
"1518","Togo","2020",85,2453,1788,4241
"1519","Togo","2020",90,376,240,616
"1520","Togo","2020",95,29,16,45
"1521","Turkey","2020",0,3210418,3356730,6567148
"1522","Turkey","2020",5,3349383,3502739,6852122
"1523","Turkey","2020",10,3311135,3462103,6773238
"1524","Turkey","2020",15,3332948,3488963,6821911
"1525","Turkey","2020",20,3320753,3449266,6770019
"1526","Turkey","2020",25,3159473,3244671,6404144
"1527","Turkey","2020",30,3176459,3218521,6394980
"1528","Turkey","2020",35,3191500,3188251,6379751
"1529","Turkey","2020",40,3030868,2977206,6008074
"1530","Turkey","2020",45,2776683,2661822,5438505
"1531","Turkey","2020",50,2439491,2315977,4755468
"1532","Turkey","2020",55,2163508,1989447,4152955
"1533","Turkey","2020",60,1865429,1580771,3446200
"1534","Turkey","2020",65,1533573,1212619,2746192
"1535","Turkey","2020",70,1108614,861882,1970496
"1536","Turkey","2020",75,799192,583891,1383083
"1537","Turkey","2020",80,521526,355837,877363
"1538","Turkey","2020",85,300443,152903,453346
"1539","Turkey","2020",90,95421,29563,124984
"1540","Turkey","2020",95,16125,2963,19088
"1541","Ukraine","2020",0,1026310,1087540,2113850
"1542","Ukraine","2020",5,1201003,1274658,2475661
"1543","Ukraine","2020",10,1166308,1237435,2403743
"1544","Ukraine","2020",15,958718,1021056,1979774
"1545","Ukraine","2020",20,1045248,1100799,2146047
"1546","Ukraine","2020",25,1343703,1408741,2752444
"1547","Ukraine","2020",30,1759947,1824887,3584834
"1548","Ukraine","2020",35,1795255,1828869,3624124
"1549","Ukraine","2020",40,1710174,1627017,3337191
"1550","Ukraine","2020",45,1595651,1473562,3069213
"1551","Ukraine","2020",50,1503996,1298962,2802958
"1552","Ukraine","2020",55,1723704,1380075,3103779
"1553","Ukraine","2020",60,1701998,1225646,2927644
"1554","Ukraine","2020",65,1612778,999434,2612212
"1555","Ukraine","2020",70,1135678,633399,1769077
"1556","Ukraine","2020",75,837583,376770,1214353
"1557","Ukraine","2020",80,867345,319817,1187162
"1558","Ukraine","2020",85,308353,103844,412197
"1559","Ukraine","2020",90,151726,36422,188148
"1560","Ukraine","2020",95,25133,4215,29348
"1561","United Kingdom","2020",0,1915127,2009363,3924490
"1562","United Kingdom","2020",5,2011016,2108550,4119566
"1563","United Kingdom","2020",10,1933970,2022370,3956340
"1564","United Kingdom","2020",15,1805522,1880611,3686133
"1565","United Kingdom","2020",20,2001966,2072674,4074640
"1566","United Kingdom","2020",25,2208929,2275138,4484067
"1567","United Kingdom","2020",30,2345774,2361054,4706828
"1568","United Kingdom","2020",35,2308360,2279836,4588196
"1569","United Kingdom","2020",40,2159877,2148253,4308130
"1570","United Kingdom","2020",45,2167778,2128343,4296121
"1571","United Kingdom","2020",50,2353119,2281421,4634540
"1572","United Kingdom","2020",55,2306537,2232388,4538925
"1573","United Kingdom","2020",60,1985177,1919839,3905016
"1574","United Kingdom","2020",65,1734370,1647391,3381761
"1575","United Kingdom","2020",70,1763853,1624635,3388488
"1576","United Kingdom","2020",75,1304709,1137438,2442147
"1577","United Kingdom","2020",80,969611,766956,1736567
"1578","United Kingdom","2020",85,638892,438663,1077555
"1579","United Kingdom","2020",90,320625,169952,490577
"1580","United Kingdom","2020",95,108377,37540,145917
"1581","Uruguay","2020",0,115658,120998,236656
"1582","Uruguay","2020",5,115718,120696,236414
"1583","Uruguay","2020",10,113959,119355,233314
"1584","Uruguay","2020",15,120242,125373,245615
"1585","Uruguay","2020",20,124869,129196,254065
"1586","Uruguay","2020",25,126815,130680,257495
"1587","Uruguay","2020",30,118842,120774,239616
"1588","Uruguay","2020",35,110995,110535,221530
"1589","Uruguay","2020",40,118233,116131,234364
"1590","Uruguay","2020",45,111679,108977,220656
"1591","Uruguay","2020",50,101540,94801,196341
"1592","Uruguay","2020",55,101984,92752,194736
"1593","Uruguay","2020",60,95541,83283,178824
"1594","Uruguay","2020",65,81040,68057,149097
"1595","Uruguay","2020",70,70486,53325,123811
"1596","Uruguay","2020",75,57744,38711,96455
"1597","Uruguay","2020",80,46053,24278,70331
"1598","Uruguay","2020",85,34361,13862,48223
"1599","Uruguay","2020",90,20077,5155,25232
"1600","Uruguay","2020",95,9555,1397,10952
"1601","USA","2020",0,9621269,10055063,19676332
"1602","USA","2020",5,9798759,10246393,20045152
"1603","USA","2020",10,10311974,10777513,21089487
"1604","USA","2020",15,10408587,10834321,21242908
"1605","USA","2020",20,10936013,11322732,22258745
"1606","USA","2020",25,11690875,12144455,23835330
"1607","USA","2020",30,11349965,11702514,23052479
"1608","USA","2020",35,10756920,10858871,21615791
"1609","USA","2020",40,10176017,10118582,20294599
"1610","USA","2020",45,10084699,9969099,20053798
"1611","USA","2020",50,10258272,10319535,20577807
"1612","USA","2020",55,10840205,10702065,21542270
"1613","USA","2020",60,10619257,10049886,20669143
"1614","USA","2020",65,9353753,8465274,17819027
"1615","USA","2020",70,7709344,6645519,14354863
"1616","USA","2020",75,5400748,4326986,9727734
"1617","USA","2020",80,3655579,2805623,6461202
"1618","USA","2020",85,2372445,1538659,3911104
"1619","USA","2020",90,1348005,703131,2051136
"1620","USA","2020",95,523945,199795,723740
